block_id,gain_per_block_pd,n_products,gain_per_block_pw,mean_gain_per_block,product_cumsum
21,1.0,10,0.7376165431828087,0.8688082715914043,10
560,0.6279264572735545,8,1.0,0.8139632286367773,18
1121,0.7351043917461997,10,0.8824501407742719,0.8087772662602357,28
487,0.6997681186907173,8,0.8779036531792526,0.7888358859349849,36
442,0.6527921715786218,10,0.8620358660224651,0.7574140188005434,46
1143,0.6486928170982549,10,0.8640569728050309,0.7563748949516429,56
1580,0.5507034335141875,8,0.9114766459092569,0.7310900397117222,64
315,0.5426090372748638,8,0.8861773836038749,0.7143932104393693,72
812,0.6274929498599001,8,0.7854682983826332,0.7064806241212667,80
1446,0.6920336239187715,10,0.7139996203239011,0.7030166221213363,90
1058,0.406916701098896,2,0.9750977933332085,0.6910072472160522,92
530,0.7162197250388915,10,0.5969444095368219,0.6565820672878567,102
1283,0.6435485291228925,9,0.6693850049331156,0.656466767028004,111
1033,0.6442687836278701,9,0.6686564011518624,0.6564625923898663,120
851,0.5091363945278721,10,0.7873412780111391,0.6482388362695055,130
2145,0.5581024116107736,10,0.7362440942987087,0.6471732529547412,140
418,0.6106990532830284,9,0.665131028360735,0.6379150408218817,149
1403,0.5782447013879009,10,0.6898607765178354,0.6340527389528681,159
1850,0.358639328605393,1,0.8827990684566702,0.6207191985310316,160
1964,0.48321761846380323,9,0.7253580853629515,0.6042878519133774,169
2173,0.5821846515797056,6,0.6238532845993213,0.6030189680895135,175
2671,0.6536095136814489,8,0.5420905714660043,0.5978500425737265,183
387,0.6312996868360506,8,0.5598885570436601,0.5955941219398554,191
726,0.4915974070837819,10,0.6864009112226371,0.5889991591532096,201
1438,0.4508341630936174,9,0.7149621794477584,0.5828981712706879,210
1554,0.5920198510269837,10,0.5596773287914802,0.575848589909232,220
1747,0.552157489630819,10,0.5963708847255236,0.5742641871781713,230
2574,0.4073705291725656,10,0.7269072707972932,0.5671388999849294,240
2037,0.5425367860392548,4,0.589440459033751,0.565988622536503,244
990,0.4615950814971359,9,0.6520455718269639,0.55682032666205,253
1409,0.7636526612162141,7,0.32695058595786675,0.5453016235870405,260
388,0.40363152772979843,8,0.6811817017510554,0.542406614740427,268
2048,0.5382559003294207,9,0.5447496410456601,0.5415027706875404,277
2223,0.46883375216471473,10,0.6047665393058345,0.5368001457352746,287
216,0.45078223251802324,7,0.6184001197851353,0.5345911761515793,294
2103,0.46966012567199295,9,0.5976342435755863,0.5336471846237896,303
2735,0.4931575822027144,10,0.5737320288874688,0.5334448055450915,313
1651,0.3221072976005815,7,0.7410555530303232,0.5315814253154524,320
314,0.5809487038805689,10,0.4817637826434547,0.5313562432620118,330
2625,0.40479432105288116,5,0.6552875244316222,0.5300409227422517,335
773,0.5207598120564734,10,0.5361320631117932,0.5284459375841333,345
879,0.4597278386268652,7,0.5939193001125659,0.5268235693697155,352
320,0.5053725567228646,10,0.5453111338679101,0.5253418452953873,362
1441,0.4495336408526549,8,0.5998040122672812,0.524668826559968,370
546,0.5438056983646384,9,0.5037031788515065,0.5237544386080725,379
1274,0.5863910282028182,9,0.45799365245733326,0.5221923403300757,388
1294,0.4634668400696322,8,0.5756999275406881,0.5195833838051601,396
2442,0.5839390018943368,4,0.4544629321155179,0.5192009670049273,400
2344,0.49910927773600766,10,0.5354368815223407,0.5172730796291742,410
1677,0.6631805445485315,9,0.35983267513896944,0.5115066098437504,419
1645,0.41622130553467046,5,0.6036729651901189,0.5099471353623947,424
846,0.4446589403001588,8,0.569576982002818,0.5071179611514884,432
301,0.4779509549581283,8,0.535280465664714,0.5066157103114212,440
1124,0.465665987053482,9,0.54497423817456,0.505320112614021,449
1879,0.45950882706892565,9,0.5502241960625983,0.504866511565762,458
256,0.4494749367237225,6,0.5572228030256441,0.5033488698746833,464
2666,0.3954626224037536,10,0.6082838907709296,0.5018732565873416,474
1860,0.4830649877285792,7,0.5201295176776657,0.5015972527031225,481
2566,0.5374724259932852,6,0.46424493921171756,0.5008586826025013,487
2195,0.5423426108435561,9,0.4573666521391539,0.499854631491355,496
2700,0.5422712627483919,6,0.45113996411793494,0.49670561343316344,502
361,0.5174768965384886,8,0.4634147319673906,0.4904458142529396,510
1679,0.40362249632534747,4,0.5763496549492918,0.48998607563731966,514
505,0.41467016182018984,10,0.5626866629412064,0.4886784123806981,524
2010,0.38255674544309204,6,0.5778416215912706,0.4801991835171813,530
2087,0.40796208616411417,10,0.5462937463068478,0.477127916235481,540
1463,0.5313175238598417,10,0.41257556757566116,0.4719465457177514,550
1211,0.36730496117624994,9,0.5682267254540738,0.4677658433151619,559
2443,0.3615880821586861,6,0.5686558663967936,0.4651219742777398,565
918,0.344889015328551,9,0.5799940107432293,0.46244151303589015,574
522,0.5176304304141575,8,0.40413445881450144,0.4608824446143295,582
1706,0.40173719064617447,10,0.5196856709705537,0.4607114308083641,592
1911,0.46010038406047427,4,0.45999363641468116,0.4600470102375777,596
779,0.44066615639231504,7,0.4794020368820571,0.4600340966371861,603
2446,0.49546962174220327,6,0.4229565003489277,0.4592130610455655,609
1551,0.4086751155455307,5,0.506922136988206,0.45779862626686835,614
2433,0.4834750134906606,9,0.4282160838282045,0.4558455486594325,623
2706,0.40860783158237,10,0.5024866110699647,0.4555472213261674,633
1572,0.4015023741304451,6,0.503105590062112,0.45230398209627853,639
2000,0.32194924802268665,5,0.582257361571966,0.4521033047973263,644
1476,0.31724208002275894,10,0.5833512030652158,0.4502966415439874,654
1252,0.5177410651186839,6,0.37813199359363425,0.4479365293561591,660
2240,0.5349662112580973,8,0.3586682459766365,0.4468172286173669,668
2109,0.4224326539459335,8,0.46998954553840483,0.44621109974216916,676
1212,0.3287544112766114,9,0.5606425616906816,0.4446984864836465,685
1240,0.49447165155035344,8,0.39142333082889713,0.4429474911896253,693
2233,0.3820148611760243,8,0.4979077707932824,0.4399613159846534,701
181,0.3403417031874082,8,0.5356601417635687,0.43800092247548844,709
439,0.34651692598086675,1,0.5289663451897444,0.43774163558530554,710
2742,0.38466332053131763,9,0.4790536439547276,0.4318584822430226,719
2608,0.571920460420999,8,0.2914588920409729,0.431689676230986,727
1809,0.4320962567086404,9,0.4311690013181712,0.4316326290134058,736
2478,0.4413742185012838,10,0.42138485520169616,0.43137953685149,746
333,0.3358621265796489,6,0.5263727831060179,0.43111745484283337,752
1247,0.5740581938545809,9,0.2875030414194539,0.43078061763701736,761
1027,0.406250183450403,8,0.4549019660270104,0.4305760747387067,769
183,0.4122045884050313,3,0.44859934278602037,0.43040196559552585,772
2646,0.33167832846766404,8,0.5268995168487953,0.4292889226582297,780
1765,0.5532498379991826,9,0.30406734705336586,0.42865859252627425,789
1691,0.5442437214805181,10,0.30748817522854094,0.4258659483545295,799
1115,0.3824393371852274,3,0.46826629732916575,0.42535281725719654,802
2644,0.4343924912903394,10,0.41337770017887554,0.4238850957346075,812
2254,0.4158171501854825,4,0.4264644936003187,0.4211408218929006,816
2220,0.37719209119912206,5,0.4585765354823356,0.41788431334072884,821
2488,0.31752160199052143,9,0.51647312989468,0.41699736594260073,830
1826,0.4495471879593318,10,0.3806894597102161,0.415118323834774,840
1588,0.3580974443383252,6,0.47012323430560715,0.41411033932196617,846
953,0.2988423997344765,8,0.528665545463539,0.4137539725990078,854
2207,0.36667953641800927,10,0.4547851220444756,0.4107323292312424,864
1393,0.40334252278736255,10,0.4162284794506995,0.409785501119031,874
2098,0.3575216923045658,10,0.4585096910987345,0.4080156917016502,884
1601,0.5558355290935404,10,0.26000673791386697,0.4079211335037037,894
670,0.24029406252892863,4,0.5746558182688375,0.40747494039888305,898
2004,0.3732724616673327,10,0.4410258741240043,0.40714916789566846,908
1412,0.30005260793092764,5,0.5105025895514207,0.4052775987411742,913
1829,0.40432694587253526,9,0.4039713585185145,0.4041491521955249,922
1348,0.39170104244985876,6,0.4150902532867384,0.40339564786829857,928
110,0.4658059738224742,10,0.33922989922540725,0.40251793652394074,938
1857,0.38140749922668626,9,0.42328136405322947,0.40234443163995787,947
1236,0.3488673489892728,9,0.4549615912171827,0.4019144701032278,956
82,0.4800281779818875,10,0.3227220102512546,0.401375094116571,966
976,0.36279377465291157,10,0.4393561014216465,0.401074938037279,976
666,0.39066920449131753,8,0.41044189485111077,0.40055554967121415,984
2555,0.4679689951885195,8,0.3320815608430948,0.4000252780158071,992
1133,0.3731708583672575,6,0.42530942265169,0.39924014050947376,998
1183,0.30987200242041624,9,0.4855121482982758,0.39769207535934603,1007
2163,0.38162425293351304,9,0.4135006938447017,0.3975624733891074,1016
2123,0.3841169205620245,8,0.40987772825351665,0.3969973244077706,1024
676,0.31567242192915296,6,0.47587853573367056,0.39577547883141173,1030
1495,0.36243477632597926,10,0.4273936305323754,0.3949142034291773,1040
606,0.4199828854885654,8,0.3688513193744435,0.3944171024315044,1048
651,0.3384767181682503,9,0.4493934540632027,0.3939350861157265,1057
409,0.31413256747023566,9,0.47197375422122295,0.3930531608457293,1066
2423,0.4231303299397834,10,0.3627069836338211,0.39291865678680227,1076
904,0.45995136588703095,9,0.3255080841597527,0.3927297250233918,1085
1913,0.3040919035716945,8,0.4809186022572012,0.3925052529144478,1093
2410,0.3606104326268515,6,0.4198522471744879,0.3902313399006697,1099
553,0.3178851160196792,8,0.46254976564359107,0.3902174408316351,1107
549,0.3771740283902199,10,0.3997307508228543,0.3884523896065371,1117
1083,0.4854108950347594,9,0.2879869947567265,0.38669894489574297,1126
1367,0.3445747224536517,10,0.4276733074333628,0.38612401494350723,1136
430,0.4153655799629261,10,0.3553126579198562,0.38533911894139117,1146
108,0.31377131129219055,7,0.4562369820562936,0.3850041466742421,1153
2160,0.39563873479055045,6,0.3725090440451013,0.3840738894178259,1159
1632,0.3565937154972124,8,0.4100702400782881,0.38333197778775024,1167
1589,0.2963136064881608,7,0.4699828611000446,0.3831482337941027,1174
1309,0.5689414516627945,10,0.19359069312278238,0.3812660723927884,1184
2243,0.3211206166642957,9,0.44080796143346435,0.38096428904888,1193
1022,0.36307149033978386,7,0.3985155199289845,0.38079350513438415,1200
2264,0.3858622394722048,8,0.37483255481907896,0.3803473971456419,1208
1887,0.515047448741135,6,0.24558091780012456,0.38031418327062977,1214
1407,0.3103416354518749,8,0.45004184458413415,0.3801917400180045,1222
303,0.32603595853682193,7,0.4339109579334925,0.3799734582351572,1229
2734,0.3524008859807765,9,0.40703416817512156,0.37971752707794904,1238
1166,0.4655508366467299,5,0.2873827215289717,0.3764667790878508,1243
184,0.3541732991043102,10,0.3984419911070232,0.3763076451056667,1253
861,0.3605517284979192,4,0.3862134795710195,0.3733826040344693,1257
1671,0.41177108099137727,7,0.3345628243623714,0.37316695267687433,1264
1454,0.29508081978058187,6,0.4504228575706612,0.37275183867562156,1270
661,0.4851941413279325,5,0.25751665093595505,0.3713553961319438,1275
428,0.38878073782058653,9,0.3524196329975963,0.37060018540909145,1284
498,0.3252953833718295,10,0.415852279259792,0.3705738313158108,1294
1501,0.3702017841539491,5,0.3708606615454956,0.37053122284972234,1299
2356,0.3852458461184154,10,0.3557123873337914,0.3704791167261034,1309
1399,0.2774018455674994,5,0.4598412312200702,0.3686215383937848,1314
165,0.45638170327772226,2,0.27899508827469294,0.3676883957762076,1316
359,0.37220224023987397,10,0.362924896324361,0.36756356828211745,1326
933,0.4302086931783543,9,0.3021713729569014,0.3661900330676279,1335
840,0.37501100702417484,10,0.3570145159263428,0.36601276147525885,1345
2610,0.4335051558030162,10,0.29229444683598793,0.36289980131950206,1355
2526,0.3377632372166112,10,0.38794742288163464,0.36285533004912296,1365
839,0.3354399084215587,7,0.38582043459544435,0.3606301715085015,1372
1410,0.4730830279589703,9,0.2456985639152627,0.3593907959371165,1381
2290,0.41529107087620437,10,0.3021526565294931,0.35872186370284875,1391
1507,0.5082355119338721,10,0.2088806774277212,0.35855809468079664,1401
1735,0.44328390897247455,10,0.27363283182220466,0.35845837039733963,1411
2699,0.41376250567285094,10,0.30248821533517106,0.358125360504011,1421
355,0.3652525745147312,10,0.3492217976861148,0.357237186100423,1431
1070,0.39549874802155804,9,0.31475683350133554,0.3551277907614468,1440
941,0.24489195053499774,10,0.46425857546597216,0.3545752630004849,1450
2143,0.3264897866104911,10,0.3764822742063566,0.35148603040842386,1460
1097,0.28582814592040157,9,0.41610227725446053,0.35096521158743105,1469
2745,0.3751735723042951,9,0.32503616281152825,0.3501048675579117,1478
2035,0.37360888148313726,9,0.3239626420108929,0.3487857617470151,1487
1794,0.37808845809089653,10,0.31731590388312386,0.3477021809870102,1497
1273,0.4053339474688362,8,0.2884696112063272,0.3469017793375817,1505
2312,0.40061955434534735,8,0.29012467814429294,0.3453721162448201,1513
2171,0.29282974222113833,4,0.39738183918310815,0.3451057907021232,1517
237,0.3298268905551828,9,0.359475726130539,0.3446513083428609,1526
1950,0.35782650220479134,10,0.3293262353510533,0.3435763687779223,1536
404,0.2002465573415157,6,0.4838824822260783,0.34206451978379704,1542
932,0.36885836274184397,9,0.31419534067908544,0.3415268517104647,1551
2128,0.15680550193159154,6,0.5261441753141017,0.34147483862284667,1557
1940,0.3501610976768968,9,0.33262166346259253,0.34139138056974466,1566
2390,0.3643787861340846,7,0.31731697339326154,0.34084787976367303,1573
436,0.40665027466758774,6,0.2691168252661075,0.3378835499668476,1579
1260,0.2734438325667928,5,0.39945134129940135,0.33644758693309706,1584
554,0.41251617185859557,10,0.25996716603877507,0.33624166894868535,1594
447,0.5290822512581876,7,0.14280366735026193,0.3359429593042248,1601
25,0.3858333389779613,8,0.28562845752574173,0.33573089825185154,1609
341,0.3361980948252308,8,0.3351938353435667,0.33569596508439875,1617
2593,0.31246175764677714,7,0.3581495335598912,0.3353056456033342,1624
1869,0.2776773034032588,9,0.39030970339810106,0.3339935034006799,1633
1700,0.31037324536745386,3,0.3565679954438868,0.3334706204056703,1636
626,0.5418558181436398,9,0.12218324451942901,0.3320195313315344,1645
68,0.2790342719220407,10,0.38465333165776744,0.3318438017899041,1655
847,0.39739082725406916,7,0.26615561907257423,0.3317732231633217,1662
513,0.25020377106292835,7,0.41240979350433016,0.33130678228362925,1669
2705,0.41377831063064024,8,0.24848062716074468,0.33112946889569245,1677
1492,0.4286914172305651,9,0.23304492209955535,0.3308681696650602,1686
1641,0.15584591520865929,2,0.5035694900843042,0.32970770264648175,1688
80,0.24585289196859766,8,0.4109686285938883,0.32841076028124294,1696
1141,0.28537431784673234,9,0.3713045082526075,0.32833941304966996,1705
2639,0.27819209345697304,6,0.37846327435876176,0.3283276839078674,1711
1521,0.3229404446611979,8,0.33232754817474724,0.3276339964179726,1719
1352,0.3471423507391074,8,0.30785047178765945,0.3274964112633834,1727
2306,0.25311414114730435,3,0.40173608233089037,0.3274251117390974,1730
4,0.32842070088214226,10,0.3237570286869357,0.32608886478453897,1740
753,0.31659136733205523,3,0.3349986497434512,0.32579500853775323,1743
2613,0.28337386176080753,10,0.3675331481298278,0.32545350494531766,1753
2525,0.3823151553740243,9,0.2665580222618535,0.3244365888179389,1762
1188,0.30630459766222073,10,0.34202934201062557,0.3241669698364231,1772
1069,0.35157451247349825,4,0.29616473664649745,0.32386962455999785,1776
790,0.3402581626962352,6,0.30588524690978414,0.3230717048030097,1782
2515,0.3076818868410177,5,0.3382272334713892,0.3229545601562035,1787
1,0.33000074509086696,7,0.31464720871222956,0.32232397690154824,1794
1847,0.36947249824452055,7,0.27460875982278216,0.3220406290336514,1801
716,0.3131842700028673,8,0.33060964751619637,0.32189695875953184,1809
1418,0.24405338463171045,6,0.39880295077846967,0.3214281677050901,1815
63,0.30095574837604055,7,0.3384050395317685,0.3196803939539045,1822
1822,0.3662415133021296,8,0.27012483857081365,0.3181831759364716,1830
814,0.38338763465259584,8,0.2524404884452799,0.31791406154893787,1838
65,0.2090928180013952,5,0.42526931602152934,0.31718106701146226,1843
1954,0.30371710028697263,8,0.32760031336647033,0.3156587068267215,1851
1858,0.3104387230497245,7,0.3206003695157525,0.3155195462827385,1858
2316,0.3335681498490624,10,0.29611928246564867,0.3148437161573555,1868
424,0.3316692970632128,5,0.2977409272118138,0.3147051121375133,1873
569,0.3334588698552038,10,0.29471555041002345,0.31408721013261365,1883
1710,0.4176333656206045,10,0.20963200829939865,0.31363268696000157,1893
453,0.38756691706235524,9,0.23774408226671978,0.31265549966453754,1902
962,0.3109038403789576,10,0.3138156645802306,0.3123597524795941,1912
6,0.2933070519463804,8,0.3313294278388141,0.3123182398925972,1920
2347,0.33104838800719794,9,0.2931139589789386,0.3120811734930683,1929
2194,0.267022504002041,6,0.3556027625446854,0.3113126332733632,1935
137,0.2448955630967781,8,0.37523094734534207,0.3100632552210601,1943
2005,0.3835976148060845,6,0.23533367379406048,0.3094656443000725,1949
490,0.3121614634487771,7,0.3060617160824913,0.3091115897656342,1956
302,0.35116584142208473,9,0.2670125640703417,0.3090892027462132,1965
2616,0.3662365460296816,5,0.2518396911254722,0.3090381185775769,1970
344,0.32288625623449113,8,0.29515806022946334,0.3090221582319772,1978
1577,0.33890616144990143,8,0.2779742408483354,0.3084402011491184,1986
2578,0.258842309420432,5,0.35723242861688276,0.3080373690186574,1991
1469,0.37366306990984394,9,0.241987363737724,0.30782521682378394,2000
2548,0.2890139738405369,5,0.3253128985596372,0.307163436200087,2005
173,0.2928184529655744,10,0.3210321842338163,0.30692531859969535,2015
2276,0.29175726294256693,8,0.3203022435648912,0.30602975325372905,2023
1835,0.2545763255279418,8,0.35743322914522074,0.30600477733658127,2031
1750,0.3602153086821147,8,0.2515260572776154,0.3058706829798651,2039
714,0.27804533313464225,7,0.3328342286024444,0.3054397808685433,2046
1104,0.20858480150101927,3,0.40173608233089037,0.3051604419159548,2049
1880,0.3685860658976424,7,0.24099672997275423,0.3047913979351983,2056
1318,0.3001564690821156,10,0.30887720151977394,0.30451683530094475,2066
1385,0.21816486377255295,3,0.3908203944888142,0.3044926291306836,2069
1522,0.3326921036173031,9,0.27433068718700115,0.3035113954021521,2078
2303,0.306322660471123,10,0.2997729964732903,0.3030478284722067,2088
982,0.34996240677897206,7,0.2556343130937452,0.3027983599363586,2095
822,0.3366794686824759,9,0.2678802041694852,0.30227983642598055,2104
1248,0.3324189036326565,9,0.26951655468004265,0.3009677291563496,2113
1606,0.19197740342606312,10,0.4079264070074304,0.29995190521674675,2123
1939,0.42265798748698913,10,0.17651943968363887,0.299588713585314,2133
2595,0.348336753977769,9,0.2494217960818496,0.29887927502980927,2142
1331,0.2514117214082667,10,0.3461830520076042,0.29879738670793543,2152
1771,0.35796874682489666,8,0.23890583765370862,0.29843729223930265,2160
1109,0.26010986703514777,10,0.33601842765967116,0.2980641473474095,2170
867,0.25534264019562003,7,0.33890637240877747,0.2971245063021988,2177
1509,0.3440671575234985,10,0.24974131223546334,0.2969042348794809,2187
261,0.3053359795348373,8,0.2882142656609706,0.29677512259790395,2195
358,0.3289860668007828,7,0.26414333574864374,0.29656470127471324,2202
2068,0.27497917132348454,3,0.31652018834073525,0.29574967983210987,2205
1471,0.29964393687951413,8,0.29152038887388604,0.2955821628767001,2213
1575,0.3402834506286984,10,0.25015334101598113,0.2952183958223398,2223
2137,0.2966838940706571,8,0.2931380229570351,0.2949109585138461,2231
1678,0.29245042323419085,8,0.29560190693657534,0.2940261650853831,2239
478,0.31229919236665676,10,0.27538682844790013,0.29384301040727845,2249
1479,0.2912921456133338,9,0.29616339975882544,0.29372777268607964,2258
1390,0.25060341070989084,3,0.3363301898647872,0.293466800287339,2261
795,0.21980857938265821,5,0.36699705617334616,0.2934028177780022,2266
671,0.36581026373958825,10,0.22076694571968672,0.29328860472963747,2276
105,0.29507178837613074,7,0.28896960719566417,0.29202069778589745,2283
477,0.31546018392455144,9,0.2665446533851333,0.29100241865484233,2292
1973,0.3235925120625694,9,0.25837493282139445,0.2909837224419819,2301
511,0.2053199487919366,7,0.3761547367267107,0.2907373427593236,2308
115,0.38481911225809956,8,0.19605056643930663,0.29043483934870307,2316
39,0.35877479967215975,8,0.22178030657508097,0.29027755312362036,2324
728,0.3429856468404759,5,0.2362855378165416,0.2896355923285088,2329
1427,0.2768170621292889,10,0.301922711849905,0.289369886989597,2339
91,0.34732072097701716,10,0.23124814506835506,0.28928443302268614,2349
2269,0.25578517901372533,8,0.32096667673788715,0.28837592787580624,2357
581,0.3056001481150328,9,0.2698922201158814,0.28774618411545705,2366
2417,0.19671076249889916,8,0.3778044561139884,0.2872576093064438,2374
2510,0.23630895531486848,9,0.3373542458215575,0.286831600568213,2383
1000,0.25928259038742446,5,0.31416860292564497,0.28672559665653474,2388
2680,0.24051081623575563,8,0.33120991008093514,0.2858603631583454,2396
2600,0.30886725867522824,7,0.2626730266869517,0.28577014268108997,2403
963,0.2867312863655143,8,0.2840886303051045,0.2854099583353094,2411
1903,0.3496666282831975,8,0.22113458982949333,0.2854006090563454,2419
369,0.262782711182459,10,0.30732320328981316,0.2850529572361361,2429
1214,0.3398201395803556,5,0.22975751531404826,0.2847888274472019,2434
1148,0.2476682042632744,4,0.32117549859225725,0.2844218514277658,2438
2265,0.4618998913973614,8,0.10649647195343352,0.28419818167539745,2446
1882,0.32920372364805506,4,0.23640719459469572,0.2828054591213754,2450
2319,0.29670195687955936,10,0.2687919615618056,0.2827469592206825,2460
185,0.3383683413148369,7,0.22653294224912632,0.2824506417819816,2467
2571,0.27170754506106337,10,0.2921166407756087,0.2819120929183361,2477
507,0.2517887825441013,5,0.31139857166921114,0.2815936771066562,2482
950,0.3591428294035433,4,0.20401841696456974,0.2815806231840565,2486
806,0.25679895416336435,6,0.30626224923329487,0.2815306016983296,2492
1593,0.31468348314175454,5,0.24799934759881603,0.2813414153702853,2497
1834,0.37445286622909507,10,0.1882129287732986,0.28133289750119683,2507
1918,0.2812379346081159,10,0.2800886623904086,0.28066329849926225,2517
2133,0.284922747624176,8,0.2762825431881562,0.2806026454061661,2525
1888,0.26339187941268755,8,0.2962021695013141,0.27979702445700083,2533
192,0.31016326521396503,7,0.24911163814194004,0.2796374516779525,2540
2511,0.3304861830801151,9,0.22680031978353107,0.2786432514318231,2549
2094,0.2906102745772736,9,0.2653000109624788,0.2779551427698762,2558
520,0.27604939275094303,8,0.2773159573586308,0.27668267505478694,2566
2208,0.24419788710292853,5,0.30900420584861615,0.2766010464757723,2571
2374,0.28527271454665715,10,0.26781202289821204,0.2765423687224346,2581
2582,0.2680046692361012,8,0.2838279372090598,0.27591630322258054,2589
677,0.24772690839220665,7,0.3038063865797868,0.2757666474859967,2596
1444,0.3294484747086805,10,0.22196506445135464,0.27570676958001755,2606
1280,0.27641742248232654,10,0.2746542140036309,0.2755358182429787,2616
2,0.3383006057814533,7,0.2122442868105336,0.27527244629599346,2623
2632,0.23589576856122932,9,0.3125496319548239,0.2742227002580266,2632
2533,0.31005488836055156,10,0.23817723387245554,0.27411606111650355,2642
2387,0.2666680213773342,10,0.28006727218765626,0.27336764678249525,2652
1830,0.3136539030343259,10,0.23255161054857848,0.2731027567914522,2662
231,0.23664763298178576,3,0.30910580931168996,0.2728767211467379,2665
1729,0.30088349714043133,7,0.2447560581064858,0.27281977762345855,2672
2008,0.34057200400091203,5,0.2049261636938741,0.27274908384739305,2677
1255,0.35313468759243055,8,0.19023644195367415,0.27168556477305233,2685
741,0.2320212960516956,2,0.3108424263976492,0.2714318612246724,2687
2033,0.3493979440007765,7,0.192954334590899,0.2711761392958377,2694
1221,0.22613056249844754,9,0.3145389208107956,0.27033474165462157,2703
467,0.31183859073964926,8,0.22792865297871948,0.26988362185918435,2711
294,0.24857586041061266,7,0.29092681074750737,0.26975133557906,2718
995,0.24350246896019168,4,0.29598158303543015,0.26974202599781094,2722
786,0.31970945971880704,9,0.21891936695694955,0.2693144133378783,2731
1105,0.1732291109259672,5,0.36531257770659586,0.26927084431628157,2736
2354,0.254308544385966,7,0.2830378365948936,0.2686731904904298,2743
1902,0.3870972840308964,9,0.1501177798039053,0.26860753191740083,2752
9,0.2596686829277102,6,0.27680259249257355,0.2682356377101419,2758
411,0.35904574180569365,4,0.17721114536514412,0.2681284435854189,2762
2489,0.39333346880440023,5,0.14254965869257732,0.26794156374848876,2767
959,0.29990358975748405,8,0.2356598743860343,0.26778173207175915,2775
366,0.18248630048837308,10,0.35291027077322906,0.26769828563080106,2785
1631,0.2688016906789131,7,0.2665740649139178,0.26768787779641545,2792
1237,0.2690161865346274,4,0.2659417170450504,0.2674789517898389,2796
290,0.21255636160840266,10,0.32230356440991115,0.2674299630091569,2806
1048,0.3135884253520553,7,0.2198979687328711,0.2667431970424632,2813
1971,0.2563090004718907,9,0.27605794605925615,0.26618347326557346,2822
1005,0.18053416241626183,4,0.3504418413756039,0.26548800189593286,2826
1054,0.2771164531868437,10,0.2534640096469814,0.26529023141691255,2836
1874,0.24364019787807134,9,0.28681588115603346,0.2652280395170524,2845
1905,0.2352409917385226,5,0.29501635013622884,0.2651286709373757,2850
1361,0.2358054545167181,8,0.29311796964195486,0.2644617120793365,2858
1738,0.27301032515313856,7,0.25555409983342375,0.26428221249328115,2865
562,0.19747617402613232,6,0.33084360285880055,0.2641598884424664,2871
2159,0.24837265381046225,5,0.279497758039374,0.26393520592491815,2876
384,0.3032881085755441,7,0.22446878768352121,0.26387844812953265,2883
2704,0.41043217528149745,2,0.1155338326163159,0.26298300394890667,2885
1845,0.20443938685795174,3,0.32146132517653603,0.26295035601724387,2888
1875,0.23971831049516917,3,0.28587203845958453,0.2627951744773769,2891
938,0.24552776140835703,7,0.279717007617586,0.2626223845129715,2898
2592,0.35656887913497193,10,0.16794116624732952,0.26225502269115075,2908
410,0.31477605503737854,9,0.20899698665518723,0.2618865208462829,2917
417,0.24964156613584568,7,0.2740111710333874,0.26182636858461655,2924
1489,0.26191976048715376,7,0.2611369427517961,0.26152835161947496,2931
1582,0.3328727317063256,8,0.18992895778910862,0.2614008447477171,2939
66,0.2510798172946878,8,0.27121707579885723,0.2611484465467725,2947
1425,0.24085626745601124,7,0.28046165405090334,0.2606589607534573,2954
1666,0.2809286090056648,10,0.24034700256415056,0.2606378057849077,2964
585,0.3865599154660542,2,0.13463795744953916,0.2605989364577967,2966
1080,0.2501879661051389,4,0.27024515846129576,0.2602165622832173,2970
1728,0.28815147471545416,10,0.23190856757833495,0.26003002114689455,2980
444,0.29482794045595023,10,0.2252120972291666,0.26002001884255843,2990
1356,0.2789845991975595,9,0.24036839276690294,0.25967649598223125,2999
2439,0.21938636122456798,8,0.2998625679473158,0.2596244645859419,3007
432,0.3167245805477094,8,0.20247030104036595,0.2595974407940377,3015
1652,0.23710146105545493,5,0.28030924885629255,0.25870535495587377,3020
2733,0.3459163375848668,8,0.16998259372251023,0.2579494656536885,3028
2056,0.16050160420321555,3,0.354686994489349,0.25759429934628225,3031
1187,0.2671652001923687,9,0.24703063879166745,0.2570979194920181,3040
1709,0.23595447269016176,9,0.277884134619241,0.2569193036547014,3049
2753,0.3134800484986418,9,0.19915348272607442,0.2563167656123581,3058
1041,0.2421003434191541,8,0.2702304526969035,0.2561653980580288,3066
1546,0.18503993009692948,6,0.32654684588091537,0.2557933879889224,3072
504,0.21070943939814712,8,0.30075560891222797,0.25573252415518755,3080
2364,0.261461416711259,7,0.24978810330398415,0.2556247600076216,3087
501,0.23199194398722947,10,0.2792170116282489,0.2556044778077392,3097
1474,0.24397210199165026,7,0.2665433164974612,0.2552577092445557,3104
1695,0.2134301499890493,4,0.2968585813482779,0.2551443656686636,3108
705,0.33702266205161874,10,0.1729865803215482,0.25500462118658346,3118
1561,0.28832758710225115,5,0.21896214736245428,0.2536448672323527,3123
2621,0.2585239524135299,9,0.24790041791108625,0.25321218516230803,3132
1854,0.23408045626655277,6,0.2718066432622198,0.25294354976438627,3138
1408,0.25521845838441715,8,0.24988836987938595,0.2525534141319016,3146
2676,0.245755804370748,7,0.2592465835835541,0.2525011939771511,3153
2746,0.22948121354981596,10,0.2745740007433095,0.25202760714656275,3163
1719,0.22988536889900382,7,0.2720459461555121,0.25096565752725797,3170
1731,0.3227101438476942,10,0.1790747667799456,0.2508924553138199,3180
2557,0.27882880747077765,3,0.22295409395111804,0.25089145071094787,3183
1948,0.3690502800864303,10,0.13248556829758049,0.2507679241920054,3193
2176,0.20579861322784626,10,0.29557784295847894,0.2506882280931626,3203
145,0.2628725736567477,10,0.23794060475450732,0.25040658920562753,3213
2665,0.285211752566612,10,0.2151921241273466,0.2502019383469793,3223
2268,0.2587000648003268,10,0.2411397769536608,0.2499199208769938,3233
1404,0.27135351400657926,8,0.22842490568257473,0.249889209844577,3241
1369,0.2828681031115444,7,0.21687392881875275,0.2498710159651486,3248
1686,0.3045976622209576,10,0.19425512629577835,0.24942639425836796,3258
1251,0.22694564675016188,5,0.27067296251634343,0.24880930463325265,3263
984,0.23146360682683845,10,0.26396312329045474,0.2477133650586466,3273
1958,0.21829581913709445,4,0.27666221928701107,0.24747901921205276,3277
1277,0.25490010137751473,10,0.24003016018588086,0.2474651307816978,3287
8,0.3168261838477846,1,0.17797450822586983,0.2474003460368272,3288
595,0.3296056211461302,10,0.16483557618521774,0.24722059866567397,3298
993,0.2674018229889883,5,0.2269767889562383,0.2471893059726133,3303
617,0.2597386763122065,5,0.2344018630866597,0.24707026969943308,3308
1756,0.24829633844285032,6,0.2454488332981286,0.24687258587048946,3314
419,0.2570540913391088,9,0.2365448940249142,0.24679949268201148,3323
913,0.18580082592193692,4,0.30644540284436217,0.24612311438314954,3327
1683,0.2868283739633639,10,0.20489541527741753,0.2458618946203907,3337
2673,0.22410075434805668,3,0.2669871632045732,0.24554395877631496,3340
2009,0.2864535706786421,10,0.20407857690981088,0.2452660737942265,3350
2115,0.28157435442392037,10,0.20893682670994618,0.24525559056693327,3360
1338,0.304283820916281,9,0.18502391692045253,0.24465386891836677,3369
362,0.19332850153195183,8,0.29582650406547534,0.2445775027987136,3377
1732,0.29669518332622086,7,0.19222840458498994,0.2444617939556054,3384
2131,0.31685553591225074,7,0.17121386726844434,0.24403470159034754,3391
119,0.2604142253651508,9,0.2268417633013639,0.24362799433325735,3400
1292,0.23235320016527458,8,0.25433352138886584,0.2433433607770702,3408
2506,0.1942813147015458,10,0.29220754913730634,0.24324443191942607,3418
952,0.2793594024822813,6,0.20645021563998148,0.24290480906113138,3424
17,0.2615404415002065,7,0.22424285366694918,0.24289164758357784,3431
1893,0.2682665799651838,3,0.21599158295521692,0.24212908146020037,3434
2575,0.2105852575869441,5,0.27347240530156175,0.2420288314442529,3439
2148,0.3133626402407772,8,0.1704678839474549,0.24191526209411607,3447
2318,0.30095349052492765,4,0.1824209966230217,0.24168724357397467,3451
226,0.253520554347605,7,0.22964789052494228,0.24158422243627364,3458
638,0.3007615731803412,6,0.18237420555450085,0.24156788936742102,3464
144,0.194001341163561,2,0.2891233492779469,0.24156234522075395,3466
2110,0.13436246187053927,4,0.3472926687753841,0.24082756532296168,3470
1422,0.2582281739177553,8,0.22261185070707992,0.2404200123124176,3478
1737,0.27146730970266336,7,0.20912826902457998,0.24029778936362167,3485
792,0.2905380233416647,10,0.18998377018366167,0.24026089676266316,3495
2660,0.2763036267862423,7,0.20390478151244779,0.24010420414934505,3502
1524,0.2522358370644321,8,0.22693668232607764,0.23958625969525488,3510
2252,0.2110842426828688,9,0.26793501656403823,0.2395096296234535,3519
2394,0.23396530585980077,7,0.2446731710708203,0.23931923846531053,3526
519,0.22721207318147013,3,0.25064905896476763,0.23893056607311888,3529
756,0.2822223576932888,8,0.19512677705793802,0.2386745673756134,3537
32,0.266433204861605,7,0.21060927318764822,0.2385212390246266,3544
2701,0.3254308544385965,9,0.1514974478814341,0.2384641511600153,3553
572,0.24173592624955106,10,0.2349914305500223,0.23836367839978667,3563
2396,0.3049679498034538,10,0.17123392058352468,0.23810093519348924,3573
813,0.24849231991943968,10,0.22721609184953062,0.23785420588448514,3583
1784,0.22217706519996644,8,0.25322524150875797,0.2377011533543622,3591
1625,0.24195358309682327,9,0.23304625898722736,0.23749992104202533,3600
2331,0.23427688931336474,7,0.2406812244821565,0.2374790568977606,3607
2082,0.2800344999650031,9,0.19430191736429925,0.2371682086646512,3616
60,0.26294482489235677,9,0.21119482998799466,0.2370698274401757,3625
1268,0.20940214360384632,9,0.26392034288495014,0.23666124324439825,3634
774,0.3309309797493332,5,0.142252869629388,0.2365919246893606,3639
276,0.316200759089544,7,0.15692788560519566,0.23656432234736982,3646
1935,0.2660471123213191,10,0.2062095758590172,0.23612834409016814,3656
1378,0.3135026270097696,8,0.15793990957291784,0.2357212682913437,3664
24,0.21260829218399663,8,0.2577452587278711,0.23517677545593385,3672
1103,0.21198512527686886,8,0.2580273420266682,0.23500623365176854,3680
0,0.1911812851236963,7,0.2779777167562827,0.2345795009399895,3687
162,0.21857127697285358,9,0.25035226990157833,0.23446177343721597,3696
2058,0.20618922147035756,8,0.26157811568356404,0.2338836685769608,3704
2206,0.2355367702342971,4,0.23174413039467595,0.23364045031448652,3708
2189,0.21277537316634249,5,0.25415036777779854,0.2334628704720705,3713
2771,0.20563830579883888,7,0.2612585995299503,0.23344845266439457,3720
1308,0.3233874991815288,4,0.1425804071090339,0.23298395314528136,3724
919,0.1887215821214316,10,0.27660794164752683,0.2326647618844792,3734
799,0.22469456919071829,2,0.2404392478135202,0.23256690850211925,3736
935,0.22513485015771076,3,0.23884033015777947,0.23198759015774512,3739
535,0.21556833499285383,8,0.24831217931406968,0.23194025715346175,3747
27,0.1736445555307191,8,0.28962601904262797,0.23163528728667354,3755
1917,0.25921711270515385,9,0.20371628035069236,0.23146669652792312,3764
1218,0.2360041454146429,10,0.2268110148849073,0.23140758014977508,3774
194,0.24739951998085308,10,0.2150049598532632,0.23120223991705813,3784
1125,0.24650992664241717,3,0.21555308379879304,0.23103150522060512,3787
380,0.24930514632004117,7,0.21257449806552353,0.23093982219278236,3794
431,0.2215448668883875,7,0.2395087739937915,0.23052682044108952,3801
1389,0.2342814050155902,7,0.2258297393336417,0.23005557217461595,3808
872,0.1831952657377866,9,0.2765432362842009,0.22986925101099376,3817
299,0.26259034226765,10,0.19708398060978116,0.22983716143871558,3827
1840,0.211673541823305,9,0.24586514011919688,0.22876934097125096,3836
1539,0.24477138128557513,10,0.21269214418066162,0.22873176273311838,3846
2527,0.22449045945012264,9,0.23283289171477234,0.2286616755824475,3855
2246,0.22796845330425206,7,0.2283337299433427,0.22815109162379738,3862
2748,0.19929825987414726,7,0.2558562364473012,0.22757724816072422,3869
1353,0.18776741424116997,6,0.2670379649361101,0.22740268958864002,3875
1527,0.24421143420960528,9,0.20887800365237708,0.22654471893099118,3884
2147,0.3333942953133783,8,0.11940813308984151,0.22640121420160988,3892
313,0.2665447427065763,8,0.18611829316877135,0.2263315179376738,3900
966,0.25634061038746964,8,0.19616821255444472,0.22625441147095718,3908
730,0.20227591392168404,9,0.24940949671526702,0.22584270531847553,3917
2611,0.20908830229916966,10,0.24084432477814346,0.22496631353865656,3927
1007,0.1962772550852451,6,0.25360358071994077,0.22494041790259295,3933
482,0.21592959117089888,6,0.23356229762862862,0.22474594439976375,3939
2628,0.20121065976667352,7,0.2477520233794916,0.22448134157308255,3946
2188,0.20923957832372603,9,0.23789916123667457,0.2235693697802003,3955
845,0.32431502441865967,9,0.12273618126057811,0.2235256028396189,3964
1810,0.2592080813007027,9,0.1876455536452916,0.22342681747299714,3973
658,0.2129785797664929,10,0.23338582845592148,0.2231822041112072,3983
2341,0.21641277130903422,10,0.2293684810014893,0.22289062615526176,3993
2377,0.2521793907866126,7,0.19303989540190852,0.22260964309426057,4000
2296,0.33466772334098727,9,0.10948575278807923,0.22207673806453326,4009
1932,0.20537413721864345,9,0.23777349379550428,0.22157381550707386,4018
123,0.2092960246015456,9,0.2337601570040882,0.22152809080281688,4027
885,0.2067920677174704,10,0.23616789170140345,0.22147997970943695,4037
1685,0.21016755513107938,8,0.23217995577575576,0.22117375545341755,4045
2187,0.24620060103996608,10,0.19606794597904292,0.2211342735095045,4055
2335,0.27076647271725607,2,0.17140691384828463,0.22108669328277036,4057
2320,0.18997559262947072,5,0.25214102560674645,0.2210583091181086,4062
532,0.154254130174148,8,0.2871787124702209,0.22071642132218444,4070
1513,0.2616623654602967,10,0.1793394705390063,0.2205009179996515,4080
2183,0.20951955186171098,9,0.23032836635000253,0.21992395910585677,4089
374,0.15554336315954642,5,0.28354585391026277,0.2195446085349046,4094
2452,0.21662952501586127,8,0.2220851169643024,0.21935732099008182,4102
2598,0.21990340912939507,4,0.2187843413020751,0.2193438752157351,4106
1043,0.23444171244459788,8,0.20420157057563706,0.21932164151011746,4114
1511,0.24853521909058252,5,0.18991692580006042,0.21922607244532147,4119
1347,0.23471491242924442,10,0.20341013307379888,0.21906252275152166,4129
246,0.28725059212145415,8,0.15060307002884998,0.21892683107515207,4137
242,0.2287406383848235,8,0.20893682670994612,0.2188387325473848,4145
293,0.170808694533065,6,0.2662304847822076,0.2185195896576363,4151
1100,0.19272565528483912,6,0.24372531771135522,0.21822548649809717,4157
968,0.2678895188293492,9,0.1673756627620634,0.2176325907957063,4166
2391,0.20042492757942543,4,0.23473875878000974,0.21758184317971757,4170
1177,0.21723011341186116,8,0.21786456258372258,0.21754733799779186,4178
457,0.23698631064870304,9,0.19736740079625023,0.21717685572247664,4187
2078,0.25517330136216143,6,0.1791362636128587,0.21715478248751008,4193
897,0.201982844847245,3,0.23202353991812902,0.217003192382687,4196
927,0.22803167313540998,4,0.20595824097667664,0.21699495705604332,4200
151,0.24432884246746991,9,0.18929660992024128,0.2168127261938556,4209
248,0.2117028938877711,10,0.22063058317714027,0.2161667385324557,4219
1863,0.21674015972038763,10,0.21542340569460675,0.21608178270749717,4229
1487,0.22065256412861609,9,0.21044055796343875,0.21554656104602743,4238
1275,0.2441346672717706,8,0.18692630807774263,0.21553048767475663,4246
1749,0.24453204906762024,6,0.18571508784688887,0.21512356845725455,4252
1967,0.1888398935197414,5,0.24078015416988632,0.21481002384481385,4257
2015,0.23053563001948513,5,0.1986935933668981,0.21461461169319163,4262
74,0.20522963474742534,7,0.22368537150771514,0.21445750312757023,4269
580,0.2275913921684175,5,0.2012711127985604,0.21443125248348893,4274
1714,0.21604699942876351,10,0.21205712253645023,0.21405206098260687,4284
1724,0.19173897434855336,9,0.23616521792605943,0.2139520961373064,4293
311,0.20725266934447795,4,0.2201065232097069,0.21367959627709243,4297
2615,0.20214089442513963,7,0.22470675368914148,0.21342382405714055,4304
328,0.19200765863097444,10,0.2342975858482418,0.21315262223960812,4314
1653,0.27931650331113855,6,0.14685711077183874,0.21308680704148864,4320
2667,0.21621859611333497,6,0.2097015264583439,0.21296006128583944,4326
584,0.17549599344320027,6,0.24999665778081995,0.21274632561201012,4332
2601,0.27052443107796564,8,0.15489982700673519,0.21271212904235043,4340
1303,0.1741435406266439,9,0.25122926821442604,0.21268640442053496,4349
1370,0.23863454196103384,3,0.1860145506854223,0.21232454632322806,4352
267,0.2536867321895058,8,0.16999382357895523,0.21184027788423054,4360
1437,0.20991693365756062,8,0.21330042807143257,0.21160868086449658,4368
978,0.22737915416381604,10,0.19563880503632328,0.21150897960006965,4378
711,0.23632024457043238,8,0.18624850602802648,0.21128437529922944,4386
669,0.17703494476167242,6,0.24481220738871073,0.21092357607519158,4392
2155,0.2386616361743872,9,0.18217367240369725,0.21041765428904224,4401
2764,0.16211822559996739,4,0.25831343598848133,0.21021583079422435,4405
841,0.23737240318898875,10,0.1810172645673965,0.20919483387819263,4415
191,0.24262597115820977,6,0.1757408363034521,0.20918340373083094,4421
2695,0.20451163809356074,8,0.2133966839838183,0.20895416103868952,4429
956,0.18030973201565134,9,0.23727216091849526,0.2087909464670733,4438
848,0.23678987760189105,9,0.18058411296166071,0.20868699528177587,4447
1391,0.2385374543631842,10,0.17869375379341873,0.20861560407830146,4457
2019,0.19956920200768113,9,0.21630307778279853,0.20793613989523985,4466
422,0.3488583175848216,6,0.06669331529426234,0.20777581643954196,4472
582,0.18157638648992203,4,0.2334125662093619,0.20749447634964197,4476
465,0.3329811085597392,6,0.08174132293056473,0.20736121574515198,4482
1079,0.24157426410987595,5,0.17308417312160596,0.20732921861574094,4487
1205,0.2481807364658758,8,0.16646524225741505,0.20732298936164542,4495
30,0.1666813426988997,5,0.24604615470998895,0.20636374870444432,4500
1132,0.23474878019593615,10,0.1773983096392275,0.20607354491758184,4510
1270,0.25203714616650735,6,0.1591070125105948,0.2055720793385511,4516
2108,0.2588806928893494,4,0.15220733523527885,0.20554401406231412,4520
1447,0.21104134351172607,1,0.1999342251265364,0.20548778431913123,4521
1797,0.22097137270574085,7,0.18960409408480677,0.2052877333952738,4528
937,0.14704481157103527,4,0.26282275810621836,0.20493378483862681,4532
118,0.1921070040799369,3,0.2176292703534464,0.20486813721669164,4535
1186,0.17432416871566644,10,0.23461576511418358,0.20446996691492503,4545
2604,0.12342091537799806,6,0.2851648248810838,0.20429287012954092,4551
2038,0.21215446411032754,7,0.19568292232950002,0.2039186932199138,4558
983,0.2131307589314944,10,0.19460138020283263,0.20386606956716352,4568
1442,0.2436672920914247,6,0.16345724499536096,0.20356226854339282,4574
1712,0.2299869721990791,7,0.17653468020309995,0.20326082620108954,4581
390,0.23007277054136488,3,0.1757622265062045,0.20291749852378468,4584
2117,0.21854418275950038,10,0.18706400750796118,0.20280409513373077,4594
347,0.24855779760171035,9,0.15588912388403295,0.20222346074287165,4603
1981,0.20771552882259825,6,0.19642222121212927,0.20206887501736376,4609
2193,0.2025585968810044,6,0.2007323470667348,0.2016454719738696,4615
1586,0.21697046053389124,9,0.18565359101397577,0.2013120257739335,4624
2300,0.1925788949625083,10,0.21003173771333383,0.20130531633792106,4634
2612,0.31310976091614545,7,0.08767041975599126,0.20039009033606836,4641
44,0.1812458370870107,5,0.21926936414948545,0.20025760061824807,4646
2261,0.23487070415602637,9,0.16532086641016247,0.2000957852830944,4655
763,0.28432667493040165,9,0.11489185915621002,0.19960926704330584,4664
2522,0.16154698926843367,9,0.23731761509934404,0.19943230218388885,4673
190,0.23578061815447743,10,0.16307088445814605,0.19942575130631174,4683
459,0.20587763801679382,8,0.1921040740314917,0.19899085602414276,4691
2370,0.24852844553724435,9,0.1492608348061379,0.19889464017169112,4700
1344,0.21959634137805664,9,0.1779464335847573,0.198771387481407,4709
631,0.2025608547321171,7,0.19454790469595162,0.19855437971403436,4716
708,0.18720566088430984,10,0.20951275791905408,0.19835920940168195,4726
627,0.2294270251231092,9,0.1664117667505341,0.19791939593682165,4735
1998,0.32706102294202505,5,0.06677753921759987,0.19691928107981246,4740
371,0.2080790428517561,8,0.18570974029620083,0.19689439157397848,4748
2739,0.24044308070237216,3,0.1530375424796058,0.19674031159098898,4751
2359,0.17446641333577176,1,0.2178164346275297,0.19614142398165074,4752
1583,0.2602286300036801,9,0.13136124576540828,0.19579493788454416,4761
724,0.2718136640633641,9,0.11932925671719215,0.19557146039027812,4770
1856,0.17229661841638827,8,0.21759183749862968,0.194944227957509,4778
2523,0.21616440768662815,10,0.17297053766948392,0.19456747267805602,4788
2456,0.1759091801968394,5,0.2118926853527913,0.19390093277481535,4793
2405,0.2194337760979364,10,0.1681564051625254,0.1937950906302309,4803
2084,0.2572053673636652,4,0.12985056269602113,0.19352796502984318,4807
590,0.17255627129435816,3,0.21422555434047316,0.19339091281741566,4810
2180,0.16288363712720044,4,0.22341799397331036,0.1931508155502554,4814
1699,0.2513101181081915,6,0.13424090181094803,0.19277550995956977,4820
2070,0.22724097367571386,8,0.15816611096702432,0.1927035423213691,4828
473,0.18092838322055355,4,0.20442616770453712,0.19267727546254532,4832
576,0.15315004097999757,2,0.23150349061371162,0.1923267657968546,4834
2543,0.17744677680464382,9,0.2069301583142381,0.19218846755944097,4843
111,0.17808800652067389,5,0.20593150322323614,0.192009754871955,4848
2355,0.27301032515313867,3,0.11032398135843834,0.1916671532557885,4851
970,0.2518655494819359,7,0.1312195356721737,0.1915425425770548,4858
1314,0.16451380563062898,7,0.2181172343537351,0.19131551999218205,4865
2569,0.2477648402909014,4,0.13437566008828805,0.19107025018959473,4869
1256,0.21573993167742517,7,0.16600936356125484,0.19087464761934,4876
2026,0.1626781726759373,7,0.21826696577300178,0.19047256922446953,4883
1730,0.23020643532724155,7,0.1505608243784141,0.1903836298528278,4890
1179,0.18470802598335048,4,0.19512276639492193,0.18991539618913622,4894
784,0.16877211282933574,6,0.21095151643168636,0.18986181463051105,4900
1759,0.16785994097977186,10,0.21155846343478524,0.18970920220727855,4910
1635,0.2507135938441946,8,0.12858346056047681,0.18964852720233571,4918
23,0.17697262807095962,9,0.20225105146215402,0.18961183976655682,4927
1768,0.21856224556840256,6,0.16040914110314622,0.1894856933357744,4933
1192,0.19713975421032778,8,0.18056138587123635,0.18885057004078207,4941
2059,0.206587957976875,10,0.16951441565976738,0.18805118681832117,4951
1836,0.1973790864282826,5,0.17861354053309736,0.18799631348068999,4956
2702,0.2586910333958757,8,0.11670227244166494,0.1876966529187703,4964
533,0.18219277984371143,6,0.19280059250861623,0.18749668617616383,4970
1223,0.18355652191583174,3,0.19119097975149932,0.18737375083366553,4973
19,0.22401044030354533,9,0.15073542190838035,0.18737293110596284,4982
174,0.20170738701148555,8,0.17190637508255277,0.18680688104701915,4990
2420,0.1931704519540572,10,0.18036085272043267,0.18676565233724493,5000
1266,0.1915312520461774,8,0.18146111127450845,0.18649618166034293,5008
1116,0.2146110061210342,10,0.1583717242909816,0.1864913652060079,5018
1579,0.18887376128643313,6,0.18339157707291115,0.18613266917967214,5024
296,0.18968116884436392,6,0.18242420515343455,0.18605268699889924,5030
42,0.16639685345868913,6,0.20500236629117952,0.18569960987493433,5036
1053,0.23397840139625498,6,0.13700745715943455,0.18549292927784478,5042
612,0.15771541593004265,8,0.2129488266136902,0.18533212127186643,5050
1980,0.202158957234042,2,0.1683275267845445,0.18524324200929326,5052
2289,0.22609895258286858,10,0.1440643524249805,0.18508165250392455,5062
426,0.1796481816396062,4,0.19033136097838785,0.18498977130899702,5066
1744,0.17589382680927249,6,0.19361903514142934,0.1847564309753509,5072
1207,0.1184084859076222,3,0.25055681371539795,0.18448264981151008,5075
2763,0.20995531712647791,5,0.15896931308037635,0.18446231510342714,5080
652,0.237525937064658,6,0.13102301318438622,0.1842744751245221,5086
2482,0.18089225760274905,10,0.1873795129985588,0.18413588530065392,5096
2334,0.19124450495485412,9,0.17692505140333092,0.18408477817909252,5105
2196,0.14467181005150148,7,0.22332307494859666,0.18399744250004907,5112
1897,0.23519899570782488,3,0.1325192578669155,0.1838591267873702,5115
2481,0.20400362159318478,5,0.16284227666622988,0.18342294912970733,5120
36,0.1549021334435164,9,0.21193546575829603,0.1834187996009062,5129
1164,0.22381626510784608,8,0.14240126416098267,0.1831087646344144,5137
239,0.1552882259838021,5,0.21091007291385358,0.18309914944882782,5142
83,0.18531313008157604,7,0.1804504241944583,0.18288177713801718,5149
736,0.1782596032052453,9,0.18723512912998022,0.18274736616761278,5158
2594,0.2076590825447787,4,0.1573463314465392,0.18250270699565896,5162
2157,0.15334195832458414,2,0.21149830348954418,0.18242013090706416,5164
2273,0.21351820618244777,10,0.15102953719622572,0.18227387168933673,5174
1813,0.1614747380328245,8,0.20300104544615952,0.182237891739492,5182
2253,0.2366860164507032,7,0.12775699660163156,0.18222150652616736,5189
2102,0.14068218713521582,9,0.22315863776493772,0.18192041245007678,5198
310,0.2380046015005677,10,0.12559391234829667,0.1817992569244322,5208
831,0.19392005852350072,4,0.16945853375507683,0.18168929613928878,5212
2066,0.19751004179282405,5,0.16583957882690778,0.18167481030986593,5217
2130,0.18836348693494448,3,0.1747780098020604,0.18157074836850245,5220
2281,0.1987270235426134,9,0.1641577741355016,0.1814423988390575,5229
260,0.18301237979765125,9,0.17963091205150758,0.18132164592457942,5238
1994,0.17165538870035818,10,0.1909463293075189,0.18130085900393855,5248
1718,0.15550046398840356,4,0.2066574332291452,0.18107894860877438,5252
570,0.1675989333911342,8,0.1943345374234966,0.1809667354073154,5260
77,0.17587757028126047,5,0.1857164247345609,0.18079699750791067,5265
1614,0.20360804607822536,9,0.15750969912006058,0.18055887259914297,5274
139,0.21710367374954545,10,0.14323280829298163,0.18016824102126355,5284
2518,0.2234708138875905,7,0.13664195206990318,0.18005638297874682,5291
2077,0.1298715960072159,9,0.22995938535252392,0.1799154906798699,5300
2661,0.16103129607427416,8,0.19866418183811355,0.17984773895619385,5308
408,0.14494681631703832,7,0.21410657133766303,0.17952669382735068,5315
1222,0.20887606429456815,9,0.14995467950791833,0.17941537190124324,5324
1051,0.18294915996649336,10,0.17535821905171886,0.1791536895091061,5334
1302,0.2507284956615389,10,0.10701384748250681,0.17887117157202284,5344
649,0.22041819918310937,10,0.13718205468940092,0.17880012693625513,5354
2710,0.26898683447016125,10,0.08778940275880139,0.1783881186144813,5364
1383,0.23385015545304896,8,0.12286265083435159,0.17835640314370027,5372
1319,0.20702462638208696,4,0.1463758312099101,0.17670022879599853,5376
834,0.23830715354968046,8,0.11504185795301107,0.17667450575134577,5384
2389,0.1903684587230947,8,0.16248666454547156,0.17642756163428314,5392
2365,0.20964689466447184,9,0.14289831899744124,0.17627260683095652,5401
2278,0.16029839760306522,7,0.19223455426828126,0.17626647593567324,5408
2088,0.20242177110356982,9,0.14949612703641413,0.175958949069992,5417
2697,0.19991239537682393,6,0.15162712598562042,0.1757697606812222,5423
1227,0.20388847118643288,7,0.14761245230653228,0.17575046174648257,5430
544,0.1310840620547799,3,0.21986855720408657,0.17547630962943322,5433
637,0.16050160420321552,9,0.1903113076633075,0.1754064559332615,5442
253,0.20164642503144045,8,0.1490094999237974,0.17532796247761892,5450
456,0.2287067706181318,6,0.12193485078996695,0.17532081070404937,5456
1050,0.15125434918570585,9,0.19909973984165896,0.1751770445136824,5465
1059,0.1822401947170799,8,0.16786228987468016,0.17505124229588004,5473
131,0.22910415241398135,8,0.1207944856057304,0.17494931900985589,5481
702,0.15703806059620806,5,0.1921976561685334,0.17461785838237073,5486
1783,0.1870878010562226,9,0.16196795212872628,0.17452787659247443,5495
2224,0.18970013479371126,7,0.15873803151311616,0.17421908315341372,5502
1578,0.1910887132280722,5,0.1572540861971695,0.17417139971262086,5507
309,0.18103224437174154,6,0.16726069042226935,0.17414646739700546,5513
1514,0.19294466684277886,9,0.1550156014791325,0.17398013416095567,5522
2062,0.24725050180740965,10,0.10064491461298439,0.173947708210197,5532
1453,0.21479614991228235,8,0.13289064526220376,0.17384339758724304,5540
1808,0.20012237553031265,10,0.1458330548150683,0.17297771517269048,5550
761,0.22277991144707923,9,0.12217816434627526,0.17247903789667723,5559
802,0.1805106807646889,4,0.1641283626067171,0.172319521685703,5563
875,0.1749021786005386,8,0.16865105360117424,0.17177661610085643,5571
2260,0.22975892923668814,9,0.11283331951882739,0.17129612437775776,5580
1965,0.18667009860035796,9,0.1558637230182645,0.17126691080931122,5589
2305,0.16222660245338089,5,0.18013090804084458,0.17117875524711273,5594
1261,0.15728055380572087,10,0.18498086913741327,0.17113071147156705,5604
56,0.1727278679789296,6,0.1694866083961893,0.17110723818755946,5610
1235,0.17643977520834306,10,0.16560562348430358,0.1710226993463233,5620
755,0.11828204624530643,5,0.22341130953495023,0.17084667789012833,5625
1815,0.18057841629807234,8,0.16078614342665698,0.17068227986236467,5633
655,0.15038868906906533,7,0.18995034799186106,0.1701695185304632,5640
379,0.17679425783304992,7,0.16348398274880144,0.17013912029092568,5647
129,0.12848301757285516,7,0.2114180902292227,0.16995055390103891,5654
2623,0.21814228526142518,10,0.1209883343181739,0.16956530978979956,5664
1478,0.24993057107828182,10,0.08890971462795752,0.16942014285311968,5674
1600,0.18246101255590982,10,0.15591505950487028,0.16918803603039007,5684
1804,0.15983553812494486,9,0.1783702269767889,0.16910288255086686,5693
2310,0.1521656178948247,5,0.18589957834562823,0.16903259812022647,5698
2236,0.1898152852004632,4,0.14795068488755442,0.1688829850440088,5702
2429,0.20239151589865848,6,0.135018970436066,0.16870524316736224,5708
2120,0.17545083642094467,9,0.16149469389282972,0.1684727651568872,5717
1293,0.18944499761796696,9,0.14739320272832035,0.16841910017314365,5726
2302,0.16105929342807265,7,0.17564832367654798,0.1683538085523103,5733
2184,0.19648723523873377,8,0.14007374272398887,0.16828048898136133,5741
2544,0.21239605417939522,8,0.12399633158022798,0.1681961928798116,5749
2649,0.12160560308332143,6,0.21470817079007384,0.16815688693669764,5755
664,0.20240732085644794,7,0.1338893003532057,0.16814831060482682,5762
619,0.20963921797068846,7,0.1259134285019104,0.16777632323629943,5769
1460,0.1700297358991552,8,0.16545589206503686,0.16774281398209603,5777
1717,0.15692742589168174,10,0.17848653620425503,0.16770698104796838,5787
2039,0.1533600211334863,9,0.18186485135145974,0.16761243624247302,5796
594,0.190414067315573,8,0.1444905522148218,0.1674523097651974,5804
16,0.14741735700464437,6,0.1873861974369189,0.16740177722078164,5810
2215,0.21029399479339522,7,0.12446691604078042,0.16738045541708782,5817
2340,0.18168250549222276,10,0.15279556581096942,0.1672390356515961,5827
766,0.1286726770663287,6,0.20555583778739736,0.16711425742686303,5833
1473,0.11419082002894557,6,0.2199755082178485,0.16708316412339702,5839
1892,0.1744424801139762,6,0.1595671692473055,0.16700482468064085,5845
1189,0.16977911442563642,4,0.16420055454100638,0.1669898344833214,5849
1477,0.17419998690446342,10,0.1596310724780282,0.16691552969124582,5859
198,0.20172093411816217,10,0.13127033740371066,0.1664956357609364,5869
1434,0.1919218602886887,7,0.1405951289160782,0.16625849460238346,5876
103,0.20159043032384344,9,0.13033184225794978,0.1659611362908966,5885
858,0.1976500285618164,6,0.13411657125744977,0.16588329990963308,5891
1468,0.1765910512328995,9,0.15515517255209177,0.16587311189249565,5900
2464,0.17879471391897464,8,0.15254022026561279,0.1656674670922937,5908
497,0.17467187778703486,6,0.15564179966470856,0.16515683872587172,5914
2061,0.18559761932178662,6,0.14444269163616333,0.16502015547897497,5920
1467,0.15301456991323067,5,0.1764558038304505,0.16473518687184058,5925
616,0.11656382154847932,6,0.21273358769849435,0.16464870462348682,5931
1258,0.17448221829356117,6,0.15433566040914107,0.16440893935135112,5937
1062,0.1966452848166285,7,0.13118611348037312,0.1639156991485008,5944
350,0.15816924400371185,4,0.16948928217153336,0.1638292630876226,5948
777,0.17671749089521527,6,0.15070868415493988,0.16371308752507757,5954
2708,0.16227853302897488,9,0.16495723296337195,0.1636178829961734,5963
1989,0.1444324778335465,7,0.18225655943936275,0.16334451863645463,5970
1763,0.2028859852923577,5,0.12284393440694324,0.1628649598496505,5975
1953,0.21254733020395156,6,0.11283198263115533,0.16268965641755345,5981
853,0.1751753785851852,5,0.14985441293251658,0.1625148957588509,5986
1002,0.1624275512024185,7,0.16252409740028823,0.16247582430135338,5993
2756,0.17609206613697473,6,0.14832367654804904,0.16220787134251188,5999
1011,0.2293005854607934,8,0.09371047825819578,0.1615055318594946,6007
1180,0.14530626621419326,1,0.17762424365579954,0.16146525493499642,6008
657,0.18172540466336556,6,0.14023817990764784,0.1609817922855067,6014
1754,0.14755734377363677,10,0.17403068959339893,0.16079401668351784,6024
433,0.12132788739644923,5,0.20014277960337218,0.1607353334999107,6029
1668,0.14292874899243382,5,0.17839161717954133,0.16066018308598756,6034
2339,0.16170052314410271,10,0.1596120886730855,0.1606563059085941,6044
1153,0.1384356252779978,6,0.18263356176287354,0.16053459352043567,6050
1108,0.1722446878407943,8,0.14795202177522643,0.16009835480801038,6058
2046,0.1262816127378928,5,0.19386475509554735,0.16007318391672007,6063
2398,0.12763406555444914,2,0.19243963283716975,0.16003684919580946,6065
2134,0.17610561324365143,9,0.14377692157549538,0.1599412674095734,6074
1914,0.2150851548547184,7,0.1046529038537124,0.1598690293542154,6081
1099,0.16162827190849374,8,0.1576899115782494,0.15965909174337156,6089
263,0.1764849322305987,7,0.142754202506397,0.15961956736849786,6096
1636,0.10114044059706608,7,0.21778033866038501,0.15946038962872555,6103
2743,0.1421859159763286,10,0.17625393379197496,0.15921992488415176,6113
943,0.1693659276719974,3,0.14903623767723786,0.15920108267461763,6116
1157,0.15967297284482457,7,0.1570321628436135,0.15835256784421903,6123
1558,0.1532155186622683,8,0.16339574816244792,0.1583056334123581,6131
640,0.18070034025816262,9,0.1357959695510464,0.1582481549046045,6140
1450,0.2295557226365378,5,0.08675064103763873,0.15815318183708826,6145
1629,0.1557307648019073,10,0.1603342753935129,0.1580325200977101,6155
43,0.20505126450951558,9,0.11018628192821982,0.1576187732188677,6164
2200,0.21409395821620716,5,0.10063421951160818,0.15736408886390768,6169
1440,0.1981422401044029,10,0.11652714015662974,0.15733469013051632,6179
2722,0.12292644598429879,9,0.19126450857346064,0.1570954772788797,6188
2263,0.17992138162425278,5,0.1341874263040671,0.15705440396415993,6193
243,0.20828902300524493,6,0.1056649278214346,0.15697697541333977,6199
2462,0.19699525173910973,4,0.1168934473787643,0.15694434955893702,6203
186,0.14326291095712557,4,0.1702860672240597,0.15677448909059263,6207
2282,0.14344579689726092,6,0.1696791202209608,0.15656245855911086,6213
1173,0.2120189930435606,7,0.10075052873907428,0.15638476089131742,6220
2736,0.19029394963637294,5,0.12202442226399253,0.15615918595018274,6225
1746,0.17791866768721523,9,0.13405908508755274,0.15598887638738398,6234
991,0.15550272183951636,7,0.15631291727606458,0.15590781955779048,6241
878,0.1725364022045657,7,0.13897990123073878,0.15575815171765223,6248
491,0.1528113633130803,3,0.15742520781918862,0.15511828556613444,6251
810,0.1815673550854709,9,0.1285364021144215,0.15505187859994618,6260
2014,0.16998457887689958,8,0.1398812308992174,0.1549329048880585,6268
1198,0.11291739200133653,9,0.19659334283414837,0.15475536741774246,6277
2136,0.1321023529066446,7,0.17717103873498338,0.154636695820814,6284
338,0.15233721457939609,9,0.15680890260238553,0.15457305859089082,6293
2531,0.21689053260449886,10,0.0918912415141055,0.15439088705930218,6303
951,0.20219282500073366,8,0.10646037598628888,0.15432660049351127,6311
2519,0.1584808274572757,5,0.15004425098194402,0.15426253921960986,6316
1078,0.17803065710240928,5,0.12984735416560828,0.15393900563400878,6321
568,0.13902266656732112,3,0.16872057176011954,0.15387161916372033,6324
632,0.1509825039117269,7,0.15672868934206408,0.1538555966268955,6331
1217,0.15344581947577207,4,0.1539319203321898,0.15368886990398095,6335
794,0.18807448199250837,5,0.11900171923754621,0.1535381006150273,6340
1215,0.2057778409976088,8,0.10092592840164383,0.1533518846996263,6348
589,0.2022266927674254,9,0.10437616810560342,0.1533014304365144,6357
169,0.1793478874416062,9,0.12722892597118202,0.1532884067063941,6366
38,0.1772706644178469,5,0.1292636690080026,0.15326716671292473,6371
2500,0.17389969270646344,5,0.13238663860985067,0.15314316565815705,6376
2235,0.1392710301897271,2,0.16626203533126738,0.15276653276049723,6378
2558,0.18572857468632792,7,0.11977042964896002,0.15274950216764396,6385
2597,0.18408034337399715,9,0.12109261155659178,0.15258647746529447,6394
393,0.1230415963910507,2,0.18178731186648234,0.15241445412876653,6396
849,0.1788330973878919,10,0.12575059558345786,0.1522918464856749,6406
84,0.09894355146432926,8,0.20554647957369324,0.15224501551901126,6414
809,0.15913334642886964,8,0.14499750002005327,0.15206542322446145,6422
252,0.23837263123195118,7,0.06560375184156278,0.15198819153675697,6429
770,0.1354620353624641,3,0.16820453311871827,0.15183328424059117,6432
1045,0.22281377921377096,5,0.08037769750510024,0.1515957383594356,6437
2535,0.21226690509574403,8,0.0908682550674727,0.15156758008160837,6445
1420,0.2135114326291095,5,0.0893535613350695,0.1514324969820895,6450
2304,0.14912203459479467,3,0.15358834020047965,0.15135518739763715,6453
1017,0.1570371574557629,6,0.14552182736502114,0.151279492410392,6459
1951,0.2229244139182974,6,0.07937503175108221,0.1511497228346898,6465
2342,0.22193321727978604,7,0.07930551359213696,0.1506193654359615,6472
1036,0.08128489791126194,1,0.21987123097943062,0.15057806444534627,6473
2382,0.1515063253698923,4,0.14894800309088427,0.1502271642303883,6477
489,0.11716215209336667,5,0.1828086940479087,0.14998542307063767,6482
2636,0.16095994797911028,9,0.13857642853132193,0.1497681882552161,6491
14,0.14196916226950151,4,0.15716184094779986,0.14956550160865068,6495
26,0.15648940277580206,4,0.14236249441849394,0.149425948597148,6499
2378,0.2010977672110345,8,0.09772782571262797,0.14941279646183125,6507
268,0.16564363432746507,9,0.13292380007646992,0.14928371720196748,6516
1250,0.12296573259366123,4,0.1754967206145405,0.14923122660410088,6520
2614,0.17765224125590703,10,0.12078245361668222,0.1492173474362946,6530
1413,0.1597994125071404,10,0.13863124092587487,0.1492153267165076,6540
1262,0.18410969543846334,8,0.11404320286200911,0.1490764491502362,6548
2231,0.19159672972844813,7,0.10644299644655256,0.14901986308750034,6555
1894,0.1701787540725989,5,0.12708587899027549,0.1486323165314372,6560
830,0.12739021763426867,2,0.16877672104234454,0.1480834693383066,6562
939,0.19763422360402697,8,0.09849519923636979,0.1480647114201984,6570
1377,0.19718942693480895,9,0.09849653612404179,0.14784298152942538,6579
2760,0.13158304715070465,9,0.16402916554145286,0.14780610634607877,6588
2065,0.11548456871656962,4,0.17987288872014395,0.1476787287183568,6592
2772,0.14975423290637357,4,0.14546808448060577,0.14761115869348967,6596
2606,0.1681263674110801,4,0.1267155611051248,0.14742096425810247,6600
1127,0.1276363234055619,6,0.16713234920575504,0.14738433630565848,6606
1612,0.20349560509280884,6,0.09086290751678462,0.14717925630479672,6612
893,0.13254037602252425,2,0.1617607345395625,0.14715055528104337,6614
2028,0.19798644837762092,9,0.09628879982246132,0.1471376241000411,6623
2541,0.14576686784120071,3,0.14830629700831274,0.14703658242475673,6626
2762,0.1587585431441479,6,0.13528634797047082,0.14702244555730937,6632
1458,0.13222879256896033,6,0.16107223738847018,0.14665051497871526,6638
1149,0.15808344566142607,9,0.13501495977304995,0.146549202717238,6647
1648,0.16313877430294485,3,0.12887730847078763,0.14600804138686624,6650
1055,0.17548651046852662,8,0.11621377368630728,0.14585014207741695,6658
1883,0.19560215760252322,10,0.09600591439106103,0.14580403599679212,6668
757,0.1158029257234719,7,0.17558415306829087,0.14569353939588137,6675
1884,0.10441206685948706,8,0.1867404806913313,0.1455762737754092,6683
1761,0.09363308564706622,3,0.19735002125651394,0.14549155345179007,6686
322,0.1605422455232456,7,0.13029173562778912,0.14541699057551738,6693
1803,0.094836520290179,2,0.1958783753071499,0.14535744779866444,6695
2164,0.17377776874637316,10,0.11678382258965836,0.14528079566801577,6705
1870,0.1369341542879979,2,0.15362443616762428,0.14527929522781108,6707
975,0.17034357720383198,7,0.1202035812546958,0.14527357922926387,6714
2444,0.13118792320596792,2,0.15935834739293533,0.14527313529945163,6716
1032,0.14526562489416311,10,0.14506969195434258,0.14516765842425283,6726
683,0.1487698098212007,4,0.1409400459354604,0.14485492787833054,6730
259,0.17524311411856874,8,0.11446565936636867,0.1448543867424687,6738
656,0.16584819563828307,10,0.12376264361515811,0.14480541962672058,6748
1591,0.13681448817902042,5,0.1527581329561528,0.14478631056758662,6753
2257,0.14981293703530593,10,0.138802362547894,0.14430764979159996,6763
403,0.1564781135202381,5,0.13071953968283676,0.14359882660153744,6768
1137,0.1824072756994257,9,0.10472375890032966,0.14356551729987768,6777
1508,0.1535361335202833,3,0.1322302227522239,0.14288317813625362,6780
223,0.13122404882377237,4,0.1543356604091411,0.14277985461645673,6784
681,0.14191723169390758,4,0.14325660489354358,0.14258691829372558,6788
2749,0.1541886524918773,6,0.13080643738151831,0.1424975449366978,6794
2181,0.1497542329063736,4,0.13499891712098563,0.14237657501367962,6798
1793,0.19938857391865858,6,0.08478407927209142,0.142086326595375,6804
339,0.17625688926820776,4,0.10765421667740632,0.14195555297280704,6808
1494,0.1768782498944453,10,0.10673711173439784,0.14180768081442158,6818
249,0.14397187620653906,5,0.13937187669617623,0.14167187645135765,6823
871,0.14773119830932102,5,0.13558581080900423,0.14165850455916262,6828
1526,0.09534453679055492,2,0.18777122108646185,0.14155787893850838,6830
1790,0.13046631399032274,7,0.15239957968251588,0.14143294683641933,6837
886,0.18909503069548578,7,0.09364764453761065,0.14137133761654821,6844
1560,0.11277966308345685,10,0.16960024384831132,0.1411899534658841,6854
1697,0.07880803524054016,9,0.20332323537511732,0.14106563530782873,6863
1576,0.1744731868891101,7,0.10718363221685387,0.14082840955298198,6870
1381,0.19366040564553078,10,0.08793913417806806,0.14079976991179943,6880
928,0.127697285385607,5,0.15298139319738077,0.1403393392914939,6885
1094,0.14015836567705042,5,0.14000556145271562,0.140081963564883,6890
2032,0.1002237530452766,8,0.17983946652834334,0.14003160978680998,6898
965,0.1356200849403588,6,0.1443624783758419,0.13999128165810035,6904
2495,0.15907012659771183,8,0.1206086582193191,0.13983939240851545,6912
2693,0.16786897238422294,10,0.11115285171509318,0.13951091204965804,6922
2376,0.1619154705700396,4,0.11703221631912042,0.13947384344458003,6926
2556,0.11891650240799817,4,0.16002545434127532,0.13947097837463673,6930
508,0.1974093416331939,6,0.08086512675032018,0.13913723419175705,6936
680,0.13930264010530613,4,0.13880369943556597,0.13905316977043605,6940
2717,0.14097886877143537,6,0.13691334026732405,0.13894610451937972,6946
823,0.13740107789812114,8,0.14019593425721183,0.13879850607766647,6954
2503,0.06398750053623965,4,0.21346085459207548,0.13872417756415756,6958
1194,0.1421001176340429,3,0.13528634797047082,0.13869323280225687,6961
1128,0.15623878130228325,7,0.12104849426341496,0.1386436377828491,6968
1538,0.1236200578461454,3,0.15306855827359672,0.13834430805987105,6971
1623,0.1437799588619526,4,0.13289599281289183,0.13833797583742222,6975
1351,0.17362875057292965,10,0.10297377293765023,0.13830126175528995,6985
2210,0.14435796874682486,3,0.1322195276508477,0.1382887481988363,6988
860,0.1581015084703284,3,0.11709932808025598,0.13760041827529218,6991
1791,0.1388713905427648,6,0.13622618000390369,0.13754878527333425,6997
2400,0.11260355069665992,8,0.1623863979700697,0.13749497433336483,7005
1946,0.10265320084262998,2,0.17233417913760044,0.13749368999011521,7007
1228,0.13914233267629858,9,0.13570479381181433,0.13742356324405647,7016
484,0.15687323746497497,7,0.11793087221225497,0.13740205483861498,7023
2367,0.15217916500150136,5,0.12197629430779966,0.1370777296546505,7028
2299,0.15181339312123068,4,0.12183191043922102,0.13682265178022585,7032
238,0.18702458122506474,6,0.08643914621005713,0.13673186371756094,7038
2432,0.14408702661329098,9,0.12933185027927585,0.13670943844628342,7047
405,0.13028252490974232,5,0.14308040309837086,0.1366814640040566,7052
510,0.1509599254005991,9,0.12153913203904784,0.1362495287198235,7061
2029,0.13822112942228354,3,0.13380373954219618,0.13601243448223987,7064
1698,0.16261721069589224,9,0.10933735825648457,0.1359772844761884,7073
2590,0.1212420890541635,5,0.15052954120688872,0.1358858151305261,7078
1456,0.13904976078067452,4,0.13263262594150313,0.13584119336108882,7082
1661,0.13186573011002498,9,0.13916947190263182,0.1355176010063284,7091
2222,0.17109047435194016,5,0.09968262286666149,0.13538654860930083,7096
629,0.15654133335139606,10,0.11403250776063294,0.1352869205560145,7106
2045,0.15314778312888477,6,0.11721296353237808,0.13518037333063143,7112
1848,0.18937274638235796,10,0.08095656986708663,0.13516465812472228,7122
2122,0.11721408266896055,6,0.15291321192610755,0.13506364729753406,7128
1357,0.13168239259966713,8,0.13835985272845408,0.1350211226640606,7136
697,0.1658346485316064,8,0.10359676259281342,0.1347157055622099,7144
1619,0.11913777181705076,5,0.14980628497632367,0.1344720283966872,7149
1929,0.10239354796466003,8,0.16596390938040598,0.134178728672533,7157
2167,0.17589789094127548,4,0.09241770787934855,0.13415779941031203,7161
765,0.14527239844750148,7,0.12288270414943196,0.1340775512984667,7168
1688,0.18137995344311,5,0.08655812921286728,0.13396904132798865,7173
811,0.14413669933777215,5,0.12365809899920589,0.13389739916848903,7178
2539,0.15444830536984722,9,0.11332128351911615,0.13388479444448168,7187
514,0.16061449675885467,4,0.10685475784953598,0.13373462730419533,7191
1423,0.11265096557002835,6,0.15472068405868405,0.1336858248143562,7197
2178,0.12613033671333634,9,0.14085983267513896,0.13349508469423765,7206
2618,0.14633584632162178,4,0.12064074352344764,0.13348829492253472,7210
2216,0.16118573309038847,8,0.10542428804047026,0.13330501056542937,7218
1264,0.14617779674372702,5,0.120327911808194,0.1332528542759605,7223
1800,0.13110889841702053,5,0.1353719087814804,0.13324040359925046,7228
1573,0.10989503250176665,9,0.15579099632890642,0.13284301441533652,7237
357,0.14061445160183242,9,0.1250457884027668,0.1328301200022996,7246
642,0.12604679622216342,9,0.13959914760042028,0.13282297191129183,7255
1646,0.12891426713539653,6,0.13668072181239185,0.1327974944738942,7261
2538,0.1239537682406146,6,0.1415416453878712,0.13274770681424292,7267
451,0.16992813259908005,6,0.09554736191955678,0.13273774725931842,7273
1853,0.16140022894610276,5,0.10374275072659844,0.1325714898363506,7278
1155,0.13354737761882496,10,0.13136659331609643,0.1324569854674607,7288
1568,0.17681232064195215,10,0.08806613850691039,0.13243922957443127,7298
277,0.1251255929681484,5,0.13973684703063877,0.13243121999939358,7303
1118,0.15021935023560667,9,0.11400042245650434,0.1321098863460555,7312
96,0.14764991566926086,1,0.11587206519733798,0.13176099043329942,7313
1562,0.1166473620396523,7,0.1467916032759095,0.1317194826577809,7320
1789,0.15196557228623225,4,0.11116033828605652,0.1315629552861444,7324
2683,0.1689572566205838,7,0.09403935262551369,0.13149830462304873,7331
117,0.13880591286049407,8,0.12417707879348557,0.13149149582698982,7339
1547,0.1130009324925095,10,0.14943997775418907,0.1312204551233493,7349
752,0.13215428348223857,7,0.1300203474303682,0.13108731545630337,7356
971,0.16260817929144109,4,0.0994109672917062,0.13100957329157364,7360
2284,0.12618000943781754,6,0.13580773416256017,0.13099387180018884,7366
992,0.054881135428167596,7,0.20688309986818285,0.13088211764817523,7373
2605,0.20728427926005688,5,0.05403699970321093,0.1306606394816339,7378
2728,0.15216110219259912,10,0.10892425996582915,0.13054268107921413,7388
348,0.17918712844237614,7,0.08173223209439495,0.13045968026838556,7395
1449,0.20077489450190666,6,0.05949150140506894,0.1301331979534878,7401
1246,0.14926879491712552,5,0.11046836522701689,0.1298685800720712,7406
1432,0.13026220424972726,7,0.1294134004272693,0.1298378023384983,7413
1135,0.13827531784899036,3,0.12072897810980125,0.1295021479793958,7416
1742,0.15658423252253892,7,0.10235880460851918,0.12947151856552905,7423
2013,0.12548684914619349,7,0.1331219268294639,0.12930438798782867,7430
168,0.1369477013946746,4,0.12163137728841747,0.12928953934154602,7434
890,0.1619511446176215,7,0.09605805301026996,0.12900459881394571,7441
2629,0.16191501899981708,4,0.09575859017173659,0.12883680458577684,7445
737,0.14146566147135117,10,0.11551511618890757,0.12849038883012937,7455
2498,0.12619129869338153,2,0.13023157568254798,0.12821143718796474,7457
2072,0.13184721573090016,3,0.12452172843533339,0.12818447208311678,7460
496,0.1337185227331739,9,0.12247014061384531,0.1280943316735096,7469
2097,0.15535370366607273,7,0.10063823017462427,0.1279959669203485,7476
2106,0.09442107568542711,8,0.1613636789009714,0.12789237729319924,7484
1516,0.1348817676264791,8,0.12045625302470836,0.12766901032559375,7492
81,0.16115412317480954,10,0.09407010104197025,0.1276121121083899,7502
1072,0.1369499592457873,9,0.11803247567532885,0.12749121746055808,7511
2245,0.15985585878495992,6,0.09487624430820073,0.12736605154658032,7517
2674,0.1317298074730355,4,0.12291612634123252,0.12732296690713402,7521
2691,0.11534232409646439,6,0.13927294700844642,0.1273076355524554,7527
733,0.14580525131011804,6,0.10854592075464635,0.1271755860323822,7533
1071,0.11525201005195307,6,0.13858846052037016,0.12692023528616161,7539
624,0.15295360793318563,9,0.10080801490897132,0.1268808114210785,7548
815,0.12274672103572135,6,0.130833977267562,0.12679034915164167,7554
386,0.15111797497849386,6,0.10219169364951618,0.126654834314005,7560
609,0.15786443410348625,6,0.09499121664799481,0.12642782537574054,7566
2583,0.08667438851747238,10,0.16580749352277918,0.12624094102012579,7576
2773,0.11284965646795315,9,0.13917936487140473,0.12601451066967895,7585
2154,0.16434491836739296,8,0.0876003668419772,0.12597264260468508,7593
2659,0.19019911988963611,8,0.061744157132429416,0.12597163851103277,7601
407,0.15900013321321552,10,0.0918080871009056,0.12540411015706054,7611
798,0.08552559387128891,6,0.165049745590276,0.12528766973078245,7617
772,0.1456065604121932,5,0.10486680588123624,0.1252366831467147,7622
100,0.1513460179408849,8,0.09910080935179663,0.12522341364634076,7630
994,0.13955326157882486,5,0.1106528557257562,0.12510305865229054,7635
1046,0.13827531784899033,2,0.11170899698665518,0.12499215741782276,7637
54,0.1892508224222677,8,0.060686678983858405,0.12496875070306306,7645
397,0.10727140950871411,8,0.1425686424975201,0.12492002600311711,7653
470,0.14101634909990757,6,0.10877319165889043,0.124894770379399,7659
2678,0.11569229101894561,10,0.1339882300409355,0.12484026052994054,7669
2175,0.1415130763447196,8,0.10808469450779806,0.12479888542625883,7677
273,0.14970230233077958,7,0.09971845145627173,0.12471037689352565,7684
1520,0.10888396677346299,3,0.13948925543377994,0.12418661110362146,7687
2217,0.13296936773395282,5,0.11536538476964092,0.12416737625179687,7692
368,0.1807545286848694,10,0.06739250754673091,0.12407351811580017,7702
1966,0.17398323319763642,6,0.07398470065748136,0.12398396692755889,7708
1792,0.13424505361267458,6,0.11363411523436977,0.12393958442352218,7714
1169,0.13853497072696025,5,0.10912746689197679,0.12383121880946851,7719
78,0.1610367149169449,3,0.08562899228081058,0.12333285359887775,7722
29,0.16259237433365162,3,0.0834982607091387,0.12304531752139516,7725
2153,0.15333292692013298,9,0.09240968655331641,0.1228713067367247,7734
2770,0.13040896457205814,4,0.11518089427090157,0.12279492942147985,7738
265,0.15548014332838855,3,0.08957013713793738,0.12252514023316297,7741
2731,0.15099830886951646,4,0.09404603706387381,0.12252217296669513,7745
828,0.10093949184802849,4,0.14408173196471688,0.12251061190637269,7749
148,0.11057374254626898,8,0.13418876319173914,0.12238125286900406,7757
389,0.1367038534744941,10,0.1079202573241391,0.1223120553993166,7767
1386,0.1441954034667045,10,0.10035480998815517,0.12227510672742983,7777
292,0.09315216336004366,7,0.14930094143629866,0.12122655239817115,7784
1484,0.1322084719089453,6,0.10991355684312692,0.12106101437603611,7790
1886,0.13209557935330618,7,0.10999510699112035,0.12104534317221327,7797
1736,0.10189907857096084,4,0.13977829054847155,0.12083868455971619,7801
146,0.11870426440339664,9,0.12275569982058962,0.12072998211199312,7810
69,0.09228289068162264,5,0.14895335064157236,0.1206181206615975,7815
1405,0.1399325805657723,9,0.10094304056384575,0.12043781056480901,7824
526,0.13657289810995274,6,0.10409408480680636,0.12033349145837954,7830
1175,0.1327164884093212,10,0.10758202474311702,0.12014925657621911,7840
1297,0.13163271987518593,7,0.10826250056817725,0.1199476102216816,7847
427,0.14224236225414813,3,0.09764092801394642,0.11994164513404727,7850
796,0.1400025739502685,6,0.09983743445908187,0.11992000420467519,7856
2607,0.11654801659068993,5,0.12307254219885932,0.11981027939477462,7861
854,0.12074084610712593,9,0.11871803167354275,0.11972943889033434,7870
1429,0.1678066556935102,6,0.07056307034970306,0.11918486302160664,7876
643,0.0942697996608707,8,0.14398146538931506,0.11912563252509288,7884
1753,0.15767703246112538,5,0.08031620067218712,0.11899661656665625,7889
892,0.10537616928464497,5,0.13259251931134242,0.11898434429799369,7894
327,0.1713632227663643,6,0.06644679320754111,0.1189050079869527,7900
969,0.08410269610001374,8,0.1534375392710754,0.11877011768554457,7908
1021,0.13202332811769715,10,0.10501653730050294,0.11851993270910005,7918
1740,0.14443473568465937,5,0.09234551594505926,0.1183901258148593,7923
1085,0.12227979742559808,5,0.11406566257489913,0.11817273000024861,7928
715,0.13432407840162197,8,0.1017863493073585,0.11805521385449023,7936
130,0.1524613963905991,5,0.08317954668812816,0.11782047153936363,7941
2064,0.13945843183208806,6,0.09617302535006403,0.11781572859107604,7947
1064,0.1359271526916971,6,0.09932540648069668,0.1176262795861969,7953
2668,0.11102757061993813,9,0.12421317476063029,0.11762037269028422,7962
1926,0.11664058848631395,6,0.11847899615778482,0.11755979232204938,7968
2758,0.0728179562383297,2,0.1622072550220185,0.1175126056301741,7970
1193,0.11901584785696057,2,0.11579452571236058,0.11740518678466058,7972
1992,0.1710773788154861,5,0.0636358531883434,0.11735661600191474,7977
367,0.12933874314459945,5,0.10496974623198209,0.11715424468829078,7982
2514,0.06410490879410427,7,0.1701697579965936,0.11713733339534893,7989
1912,0.11563584474112602,8,0.11794825175199124,0.11679204824655863,7997
2741,0.1254123400594717,9,0.10770769218428729,0.1165600161218795,8006
1550,0.11926195362825381,4,0.11367021120151437,0.1164660824148841,8010
2114,0.10732695264608846,8,0.12510969163348956,0.11621832213978901,8018
2483,0.10557937588479538,4,0.12582920457857288,0.11570429023168413,8022
52,0.12672189370488524,5,0.10410076924516648,0.11541133147502586,8027
1462,0.14141824659798274,8,0.08881212182789976,0.11511518421294126,8035
2465,0.1496345667973962,3,0.0801651323652484,0.1148998495813223,8038
1584,0.1353626899135016,9,0.09401528864741727,0.11468898928045942,8047
2362,0.09356535011368275,2,0.1357315315652548,0.11464844083946878,8049
1969,0.1136669985707802,4,0.11517822049555751,0.11442260953316885,8053
2754,0.08832713553202871,8,0.1403023505159049,0.1143147430239668,8061
1807,0.12199395347471989,9,0.10605396213399357,0.11402395780435673,8070
1362,0.12271646583081004,9,0.10480263527297909,0.11375955055189457,8079
1012,0.11810141815628383,3,0.10939350753870958,0.1137474628474967,8082
1656,0.11822108426526132,7,0.10925313433314705,0.11373710929920419,8089
22,0.11641480337503578,9,0.11102718427392293,0.11372099382447935,8098
1617,0.10663605020557726,3,0.12072897810980125,0.11368251415768926,8101
929,0.17151765978247857,10,0.055256241260096824,0.1133869505212877,8111
620,0.12210233032813345,5,0.10448846667005347,0.11329539849909345,8116
575,0.12594067721986268,6,0.10035213621281111,0.1131464067163369,8122
446,0.1397293739656219,10,0.08616642112496424,0.11294789754529308,8132
1603,0.13007254475625363,6,0.09575056884570443,0.11291155680097903,8138
719,0.11184942842499077,5,0.11322636449440243,0.1125378964596966,8143
18,0.11737664794908091,5,0.10732801608543246,0.1123523320172567,8148
1417,0.1195261222084493,5,0.1049376609278535,0.1122318915681514,8153
445,0.14610554550811797,7,0.07826407809563027,0.11218481180187412,8160
193,0.13536946346684,10,0.08891773595398968,0.11214359971041485,8170
909,0.11097338219323137,5,0.1132664711245632,0.11211992665889728,8175
2295,0.17960076676623776,10,0.04451702259072788,0.11205889467848282,8185
1739,0.13403733131029863,6,0.09005943802589818,0.11204838466809841,8191
1544,0.10720277083488555,10,0.11662526771175631,0.11191401927332092,8201
2650,0.1260029939105755,7,0.09750536760400316,0.11175418075728934,8208
2626,0.11650511741954697,9,0.10656599011237877,0.11153555376596287,8217
2346,0.15521145904596753,5,0.06732833693847377,0.11126989799222065,8222
394,0.11969997674413345,9,0.10282537840605556,0.1112626775750945,8231
234,0.14413218363554667,5,0.0781785172846207,0.11115535046008368,8236
1604,0.0996999315871112,2,0.12232789576554194,0.11101391367632657,8238
793,0.11684379508646431,6,0.10517161627045771,0.11100770567846101,8244
2774,0.16208751882483355,10,0.05984390499541447,0.11096571191012401,8254
1065,0.12886911011314084,9,0.0928762603508528,0.11087268523199681,8263
2647,0.1245633880410657,10,0.09704868677523977,0.11080603740815273,8273
1755,0.12068214197819362,10,0.10024117453603314,0.11046165825711338,8283
304,0.11701764962214856,10,0.1035847306037652,0.11030119011295689,8293
2294,0.14503758193177219,8,0.075189236449975,0.11011340919087359,8301
1525,0.12439404920760708,5,0.09562891206755025,0.11001148063757867,8306
245,0.12022876547474698,6,0.09970321093681066,0.10996598820577883,8312
2152,0.10790270467984794,5,0.11193359411555517,0.10991814939770156,8317
1650,0.10270738926933672,4,0.11673435774579347,0.1097208735075651,8321
1330,0.1556585135662983,10,0.06369066558289639,0.10967458957459736,8331
1209,0.09196679152583316,1,0.1273265187712398,0.10964665514853647,8332
1820,0.12394022113393795,8,0.09534950254409723,0.10964486183901759,8340
1988,0.07748945019067553,6,0.14123549811097771,0.10936247415082662,8346
399,0.06705366234739747,4,0.15165252685138889,0.10935309459939319,8350
2307,0.10145653975285554,8,0.11703382058432686,0.1092451801685912,8358
2624,0.1289007200287198,6,0.08950596652968024,0.10920334327920002,8364
1490,0.08249962180993858,7,0.13567805605837385,0.10908883893415622,8371
1505,0.12825723246157691,10,0.08975195386133265,0.10900459316145478,8381
1506,0.12180203613013348,1,0.09615965647334379,0.10898084630173863,8382
1010,0.11225358377417873,2,0.1057050344515953,0.10897930911288702,8384
1983,0.09397627901620906,4,0.12356050619914812,0.1087683926076786,8388
35,0.14306060749742036,8,0.07432614176891629,0.10869337463316833,8396
2199,0.14487501665165184,7,0.07242856340724539,0.10865179002944861,8403
235,0.120957599813953,9,0.0960954858650866,0.10852654283951979,8412
895,0.1490917793898834,4,0.06758528674903677,0.10833853306946009,8416
270,0.1331341908651859,8,0.08326671176434412,0.10820045131476502,8424
28,0.10890970627614867,8,0.1072130437456384,0.10806137501089354,8432
1997,0.13065507034335136,4,0.08535493030804565,0.10800500032569851,8436
2250,0.10481396435756221,8,0.11086007331491997,0.10783701883624108,8444
401,0.09922126715120148,1,0.11643088424424403,0.10782607569772276,8445
1295,0.11459045967590796,7,0.1010245907118392,0.10780752519387357,8452
1485,0.1286907398752311,8,0.08649395860461014,0.10759234923992061,8460
2441,0.12772889530118597,5,0.08620118020443684,0.10696503775281141,8465
2006,0.08567867617673552,6,0.12818212688133512,0.10693040152903532,8471
653,0.11249517384324637,5,0.10130132645994817,0.10689825015159726,8476
739,0.12436018144091535,5,0.08929473827750044,0.10682745985920789,8481
1430,0.11709667441109592,7,0.09641767579404444,0.10675717510257018,8488
1515,0.11632674718163727,4,0.09684146918607604,0.10658410818385666,8492
593,0.11454981835587791,8,0.09845108194319296,0.10650045014953544,8500
881,0.14445279849356163,10,0.06849811365149476,0.1064754560725282,8510
167,0.08510969769631448,1,0.12766475135226188,0.10638722452428817,8511
675,0.09737660279205862,3,0.11531458303810396,0.10634559291508129,8514
2054,0.11225132592306591,7,0.10016577407133097,0.10620854999719845,8521
1626,0.08021241863269052,3,0.13162996018748513,0.10592118941008782,8524
255,0.11819082906035001,8,0.09316101742499391,0.10567592324267197,8532
1927,0.08324697052826939,4,0.1280725020922292,0.1056597363102493,8536
2388,0.11632223147941172,9,0.09494576246714599,0.10563399697327885,8545
781,0.11503525634512608,3,0.09615965647334379,0.10559745640923493,8548
2386,0.11548592342723728,10,0.09564602422975216,0.10556597382849472,8558
1488,0.13627486176306552,9,0.0747333577538148,0.10550410975844016,8567
2549,0.13870882526264447,6,0.07224006224549001,0.10547444375406724,8573
2412,0.1133779936283441,9,0.09746445884123923,0.10542122623479167,8582
529,0.12616646233114087,10,0.08466643315695328,0.10541644774404707,8592
1316,0.12049293405494248,5,0.09002040090587508,0.10525666748040878,8597
288,0.10733598405053969,8,0.10296842538696213,0.10515220471875092,8605
2298,0.1222919898216071,8,0.08787362668213891,0.10508280825187301,8613
1762,0.13041348027428368,8,0.07887236198640117,0.10464292113034243,8621
660,0.11397858202434408,10,0.09518239158509421,0.10458048680471915,8631
1061,0.11439402662909597,6,0.09452196907511437,0.10445799785210516,8637
1060,0.1266744788315168,9,0.08221190739111717,0.10444319311131699,8646
207,0.10722083364378779,10,0.10133742242709283,0.10427912803544032,8656
1337,0.10587741223168258,5,0.10177859535886077,0.10382800379527168,8661
1401,0.11685282649091547,9,0.09080007379619948,0.10382645014355747,8670
622,0.1424771787698775,8,0.0651331673810103,0.1038051730754439,8678
1296,0.11181781850941179,6,0.09539361983727403,0.10360571917334291,8684
748,0.11468754727375757,10,0.09251530067940629,0.10360142397658192,8694
778,0.0796140880878033,3,0.126948179560057,0.10328113382393014,8697
650,0.10510748500222394,4,0.10131736911201247,0.10321242705711821,8701
2474,0.15455442437214803,10,0.05147472079100971,0.10301457258157887,8711
2759,0.0685483597840591,6,0.13720879244284134,0.10287857611345022,8717
2630,0.08375272917753257,9,0.12199233695986396,0.10287253306869826,8726
2419,0.07229187692905152,9,0.13338930436386875,0.10284059064646014,8735
543,0.09430818312978802,2,0.11106729090408364,0.10268773701693583,8737
50,0.09656332482123456,10,0.10860821972016263,0.1025857722706986,8747
2091,0.14261264983664437,6,0.06241260096844144,0.10251262540254291,8753
372,0.08868613385896107,5,0.1162290142057684,0.10245757403236473,8758
2301,0.085818662945728,2,0.11892016908955273,0.10236941601764037,8760
2505,0.09561547892408875,3,0.10896035593297379,0.10228791742853127,8763
1428,0.11799304130287036,7,0.08646187330048152,0.10222745730167594,8770
2512,0.12634483256905063,7,0.07805151295577843,0.10219817276241452,8777
1161,0.1168189587242237,5,0.08736962002978585,0.10209428937700477,8782
1006,0.13778762200862946,4,0.06611577981994796,0.1019517009142887,8786
536,0.11040214586169754,4,0.093110215693457,0.10175618077757727,8790
1110,0.11129625490235912,10,0.09124659427865552,0.10127142459050731,8800
1682,0.08825127173463924,8,0.1142381210845902,0.10124469640961473,8808
1708,0.0903682329379836,8,0.11206193533206951,0.10121508413502656,8816
2561,0.09218354523266026,6,0.11015285973641922,0.10116820248453974,8822
916,0.10467171973745702,1,0.0975673991919851,0.10111955946472106,8823
2107,0.12186299811017857,4,0.08012368884741566,0.10099334347879713,8827
2713,0.10175231824863001,1,0.09972112523161578,0.1007367217401229,8828
2113,0.09871776635305109,9,0.10267832076213292,0.100698043557592,8837
134,0.10896615255396826,5,0.09228936666283426,0.10062775960840126,8842
1942,0.08153326153366795,10,0.11964342532011774,0.10058834342689285,8852
2330,0.09834747877055484,3,0.10238687924963169,0.10036717901009326,8855
1901,0.1201063899444342,10,0.08060229463400023,0.10035434228921722,8865
1182,0.054077792002239784,4,0.14656834303468153,0.10032306751846065,8869
2458,0.09008825939999861,2,0.11041756349547996,0.10025291144773929,8871
2652,0.10220614632229913,4,0.097918733272193,0.10006243979724606,8875
305,0.10250644052029916,9,0.09744574241383093,0.09997609146706504,8884
2266,0.12119693203190791,3,0.07869188215067792,0.09994440709129292,8887
1136,0.10598578908509608,5,0.09365967652665887,0.09982273280587747,8892
1627,0.09289702618429932,4,0.10674780683577403,0.09982241651003668,8896
684,0.0987900175886601,9,0.10077726649251476,0.09978364204058743,8905
865,0.11089074484250352,8,0.08860142833078878,0.09974608658664616,8913
319,0.12653674991363714,6,0.07262909655804899,0.09958292323584306,8919
1341,0.10253353473365254,5,0.09652061614479028,0.0995270754392214,8924
1379,0.10211809012890065,5,0.09676927725178673,0.09944368369034369,8929
1823,0.09542085215816695,10,0.10300318446643475,0.09921201831230085,8939
138,0.11660897857073506,6,0.08099935027259139,0.09880416442166323,8945
2384,0.10912826626386594,3,0.08840517322053566,0.0987667197422008,8948
2297,0.07612345026744245,5,0.12097362855378165,0.09854853941061205,8953
163,0.07898188977622438,6,0.11774638171351563,0.09836413574487,8959
2449,0.07833614435796875,6,0.11831054831110975,0.09832334633453925,8965
2656,0.06850997631514183,9,0.12808720785662145,0.09829859208588164,8974
2185,0.1064825163299081,8,0.08998858297928089,0.0982355496545945,8982
2726,0.12267356665966728,1,0.07370395424635631,0.0981887604530118,8983
2050,0.12566521938410327,10,0.07038847281973674,0.09802684610192,8993
1844,0.10999799051250955,5,0.08595118220976836,0.09797458636113895,8998
1140,0.127905007687983,9,0.06758769314684641,0.0977463504174147,9007
782,0.11108175904664483,5,0.08439103429651633,0.09773639667158057,9012
455,0.138641089729261,8,0.056722807036307187,0.0976819483827841,9020
1720,0.11144933720780575,7,0.08389879225567709,0.09767406473174142,9027
2205,0.11461755388926134,4,0.08066245457924134,0.09764000423425134,9031
2209,0.12322899803341164,7,0.0719098509905001,0.09756942451195587,9038
2093,0.10516167342893068,4,0.08978136539011718,0.09747151940952392,9042
161,0.09741724411208873,1,0.09720376574519454,0.09731050492864163,9043
1431,0.0855432051099686,5,0.10893361817953331,0.09723841164475096,9048
1279,0.10004086710514132,6,0.09440298607230423,0.09722192658872278,9054
1945,0.09153102626106627,7,0.10272511183065375,0.09712806904586001,9061
745,0.11504202989846435,6,0.0788723619864012,0.09695719594243277,9067
1172,0.11807432394293046,7,0.07568789555163995,0.0968811097472852,9074
1654,0.12122402624526125,6,0.07213578500707213,0.09667990562616668,9080
787,0.1426993513193752,9,0.050642641903941944,0.09667099661165857,9089
598,0.12646675652914088,9,0.06679892942035225,0.09663284297474656,9098
1534,0.04052165392109712,10,0.1527033205615998,0.09661248724134847,9108
502,0.09301895014438955,10,0.10020374168121646,0.096611345912803,9118
1922,0.12835206220831372,9,0.06465055093140966,0.0965013065698617,9127
1571,0.09126685768087077,10,0.10164891725467441,0.09645788746777259,9137
2672,0.13179754300641902,6,0.06092598187715072,0.09636176244178488,9143
1518,0.11570358027450943,10,0.07685767226466098,0.0962806262695852,9153
1082,0.09870647709748716,9,0.0936222436718422,0.09616436038466468,9162
1001,0.09573740288417895,9,0.09649521527902181,0.09611630908160038,9171
329,0.1282594903126897,10,0.06362916874998327,0.0959443295313365,9181
2438,0.11840306706495153,10,0.07332427814750148,0.0958636726062265,9191
321,0.10746693941508101,10,0.0841276674251276,0.09579730342010431,9201
1866,0.10968866491005838,5,0.08173998604289269,0.09571432547647554,9206
987,0.12634709042016343,5,0.06503423769328054,0.09569066405672198,9211
2085,0.1217230113411861,6,0.06895131857231092,0.09533716495674852,9217
1233,0.1276295498522236,6,0.06298077822905164,0.09530516404063763,9223
89,0.08940638836393848,7,0.10119838610920233,0.0953023872365704,9230
364,0.12458822440330629,7,0.06576016769918956,0.09517419605124793,9237
2249,0.1511924840652157,4,0.03907990042860618,0.09513619224691094,9241
1395,0.10305871090248558,9,0.08709502330195212,0.09507686710221885,9250
2491,0.13038412820981748,5,0.0594781325283487,0.0949311303690831,9255
2025,0.09730435155644963,7,0.09229872487653841,0.09480153821649402,9262
149,0.0979049399524496,2,0.0912853640211442,0.09459515198679691,9264
286,0.0901650263378332,2,0.09876525054611861,0.0944651384419759,9266
2071,0.12743537465652433,5,0.06143667296786389,0.09443602381219411,9271
679,0.09299637163326173,7,0.09570511466485562,0.09435074314905867,9278
1003,0.10834072779572762,1,0.08018652256800078,0.09426362518186421,9279
450,0.12831367873939645,7,0.06012117549859226,0.09421742711899435,9286
704,0.0999008803361488,10,0.08813164600283954,0.09401626316949417,9296
2504,0.10444367677506602,4,0.08318516161635067,0.09381441919570835,9300
2563,0.13417280237706555,4,0.05342069448640786,0.09379674843173672,9304
701,0.09100268910067529,7,0.09657275476399921,0.09378772193233725,9311
1543,0.07835646501798378,8,0.108805276963019,0.09358087099050139,9319
2603,0.14345031259948648,9,0.043678794020368804,0.09356455330992765,9328
587,0.09328537657569783,2,0.09347117536490349,0.09337827597030066,9330
90,0.1141298580489005,10,0.07262642278270495,0.09337814041580272,9340
1126,0.08319955565490098,1,0.10338286056528959,0.09329120811009528,9341
2067,0.06993693821841998,5,0.11657927877583865,0.09325810849712932,9346
512,0.09472362773453989,4,0.09148589717194781,0.09310476245324385,9350
1400,0.10098239101917134,8,0.08509691098734502,0.09303965100325817,9358
601,0.1142924233290208,7,0.07122402761475176,0.09275822547188628,9365
2317,0.111515266460299,6,0.07344727181332769,0.09248126913681334,9371
104,0.12331253852458457,4,0.061619826578931176,0.09246618255175787,9375
1216,0.10643735930765251,5,0.07796996280778498,0.09220366105771874,9380
827,0.07617944497503942,9,0.10794886672032042,0.09206415584767992,9389
2321,0.036263346722390434,5,0.14778624770389542,0.09202479721314293,9394
1271,0.0918186764928347,7,0.09206370002379659,0.09194118825831565,9401
1167,0.08610315218593852,3,0.09769440352082737,0.09189877785338293,9404
158,0.08354952257738217,3,0.10021978433328074,0.09188465345533145,9407
2272,0.09458138311443462,9,0.08854474429349495,0.09156306370396478,9416
306,0.1215107733365846,5,0.061547634644641885,0.09152920399061323,9421
1693,0.12710572839405812,5,0.05594072774817314,0.09152322807111563,9426
1448,0.07923251124974313,9,0.10381066462033726,0.0915215879350402,9435
1191,0.08517291752747237,4,0.09774654214003631,0.09145972983375433,9439
1947,0.12225812205491542,2,0.06062518215094531,0.09144165210293037,9441
240,0.06393556996064563,7,0.11893888551696105,0.09143722773880333,9448
2327,0.06099810566291637,8,0.12178244559535617,0.09139027562913626,9456
150,0.06450003273884111,4,0.11818354398226748,0.09134178836055429,9460
1774,0.11671735542414853,10,0.06576150458686157,0.09123943000550505,9470
1380,0.10376045102833818,7,0.0785568564958035,0.09115865376207084,9477
461,0.08671502983750243,4,0.09505672414392398,0.09088587699071321,9481
1076,0.11270289614562229,6,0.06901816295591212,0.0908605295507672,9487
1481,0.06188318329912687,10,0.11970492215303084,0.09079405272607885,9497
142,0.11229422509420875,5,0.0690957024408895,0.09069496376754912,9502
588,0.1086071542270359,6,0.07258364237720018,0.09059539830211805,9508
1374,0.11446627786470497,8,0.06659705938187661,0.09053166862329079,9516
336,0.11269386474117116,5,0.06790720930046015,0.09030053702081565,9521
2104,0.10713051959927655,7,0.07323203289813184,0.0901812762487042,9528
2453,0.12684607551608829,5,0.05317604404242746,0.09001105977925787,9533
2383,0.08641021993727686,6,0.09338026700320584,0.08989524347024136,9539
2118,0.014746025617578715,7,0.16502808800998917,0.08988705681378394,9546
324,0.08249962180993858,5,0.09689628158062902,0.0896979516952838,9551
1721,0.11082436401978768,6,0.06849677676382275,0.08966057039180522,9557
1541,0.11702893887771246,10,0.06222543669435805,0.08962718778603526,9567
985,0.09023050402010388,3,0.08881212182789977,0.08952131292400183,9570
2186,0.10400791151029913,3,0.07459833209894037,0.08930312180461975,9573
2314,0.046798480014630855,7,0.1313706039791124,0.08908454199687163,9580
1959,0.07162445614011317,2,0.10653310267564697,0.08907877940788007,9582
2445,0.11084694253091555,8,0.06664919800108554,0.08874807026600054,9590
1825,0.06562218474189373,3,0.11184134886618555,0.08873176680403963,9593
1113,0.10375729003678034,7,0.07345529313935983,0.0886062915880701,9600
2546,0.09808782589258491,5,0.07911166487969348,0.0885997453861392,9605
1674,0.09972025224712625,7,0.07746328238008786,0.08859176731360704,9612
1703,0.10602643040512616,9,0.07114782501744638,0.08858712771128627,9621
2440,0.0786883691315627,4,0.09836552113218343,0.08852694513187306,9625
707,0.09126459982975799,5,0.08569851043975582,0.0884815551347569,9630
1639,0.10555453952255471,8,0.07125878669422439,0.08840666310838954,9638
227,0.08844454378989337,9,0.08825463966866574,0.08834959172927956,9647
1206,0.09622284087342707,7,0.08022930297350556,0.08822607192346632,9654
791,0.10997315415026894,7,0.06637780980366467,0.08817548197696681,9661
1925,0.11406438036662978,5,0.0620716946120753,0.08806803748935253,9666
1633,0.12346155669802814,7,0.052598508568113087,0.0880300326330706,9673
59,0.12041797339799815,9,0.055594473841118916,0.08800622361955854,9682
844,0.11998446598434398,10,0.055549287037804505,0.08776687651107425,9692
1090,0.0887403222856678,10,0.0862867410154464,0.0875135316505571,9702
2003,0.10849426167139682,3,0.06652754122293138,0.0875109014471641,9705
1649,0.14273863792873764,4,0.03224546327168498,0.08749205060021131,9709
1599,0.07851225674476571,1,0.09644441354748491,0.08747833514612531,9710
1242,0.10264642728929164,9,0.07226412622358643,0.08745527675643903,9719
2517,0.05765648601599913,7,0.11724371194883462,0.08745009898241687,9726
99,0.10839040052020882,7,0.06644465418726588,0.08741752735373734,9733
877,0.10792076748875018,5,0.06662914468600518,0.08727495608737768,9738
1764,0.12629606298501456,9,0.04792341237904508,0.08710973768202981,9747
1421,0.03120576022975893,3,0.1429306716791042,0.08706821595443157,9750
474,0.027080666246706353,1,0.146984115100681,0.08703239067369367,9751
961,0.09610001377289176,10,0.07788761052718826,0.08699381215004001,9761
525,0.06426476465288926,6,0.10940233099734493,0.0868335478251171,9767
1289,0.1394426268742986,7,0.0339328828913137,0.08668775488280614,9774
2211,0.07555672963813417,3,0.09774921591538034,0.08665297277675726,9777
735,0.10278641405828412,3,0.0704700229677302,0.08662821851300716,9780
801,0.07490195281542741,3,0.09834012026641496,0.08662103654092118,9783
1553,0.10500181757014568,9,0.06796362596021957,0.08648272176518262,9792
1605,0.09551387562401358,3,0.07733895182658962,0.0864264137253016,9795
920,0.10244186597847357,3,0.07025745782787839,0.08634966190317597,9798
2076,0.05841060828766828,1,0.11413143744836265,0.08627102286801547,9799
1531,0.08452717210921674,10,0.08793913417806808,0.08623315314364241,9809
518,0.09568321445747222,7,0.07669323508100201,0.08618822476923711,9816
838,0.10988284010575763,7,0.06217196118747709,0.08602740064661736,9823
883,0.08944206241152045,2,0.0821124429483186,0.08577725267991952,9825
2687,0.10970672771896069,9,0.06163319545565142,0.08566996158730605,9834
1990,0.10794334599987804,6,0.06295537736328319,0.08544936168158061,9840
438,0.09370985258490079,7,0.07700606679625564,0.08535795969057822,9847
340,0.10461527345963748,6,0.06599813370480984,0.08530670358222366,9853
1159,0.0973788606431714,4,0.07315984096384252,0.08526935080350696,9857
282,0.08198031605399873,2,0.088547418068839,0.08526386706141886,9859
2286,0.06294663117324716,5,0.10719299043055804,0.0850698108019026,9864
1904,0.09798170689028417,6,0.07209968903992749,0.08504069796510583,9870
2348,0.09584577973759249,6,0.07417320181923674,0.08500949077841462,9876
1342,0.10169135626858489,4,0.06809169979919946,0.08489152803389217,9880
2057,0.08147229955362283,4,0.08829474629882647,0.08488352292622464,9884
842,0.09730028742444663,6,0.07222268270575369,0.08476148506510016,9890
1778,0.06392653855619453,8,0.10516894249511366,0.08454774052565409,9898
541,0.1376273145796218,10,0.03114279831979957,0.08438505644971069,9908
1871,0.11380698533977264,6,0.05347684376863287,0.08364191455420275,9914
1837,0.08790943307616406,5,0.0792854602770566,0.08359744667661033,9919
1806,0.11004314753476518,5,0.056712111934931,0.0833776297348481,9924
2392,0.0839739985865852,7,0.08246056849811367,0.08321728354234945,9931
2577,0.07203899760441997,5,0.09415031430229169,0.08309465595335583,9936
1009,0.07343615587300943,9,0.09244952580594275,0.08294284083947609,9945
641,0.08589994558578815,3,0.0795809124525739,0.08274042901918102,9948
326,0.08236189289205889,6,0.08224506220538337,0.08230347754872114,9954
1095,0.08141585327580328,8,0.08312099100809352,0.0822684221419484,9962
2177,0.08748721491807385,6,0.07699670858255146,0.08224196175031265,9968
1602,0.0963312177268406,5,0.06802752919094232,0.08217937345889145,9973
494,0.0973201565142391,9,0.06700079945882789,0.0821604779865335,9982
1232,0.0948861930146602,3,0.06939917594243897,0.08214268447854958,9985
2570,0.0823754399987356,4,0.08187501169776712,0.08212522584825135,9989
634,0.09960510184037437,4,0.06452755726558343,0.0820663295529789,9993
1504,0.09151070560105122,2,0.07241519453052515,0.08196295006578819,9995
352,0.10281350827163749,9,0.06109309283615372,0.0819533005538956,10004
2430,0.07651857421217928,5,0.08738566268185013,0.08195211844701471,10009
1537,0.09679633505607371,6,0.06704491675200466,0.08192062590403919,10015
1350,0.09843327711284056,5,0.0652214019673639,0.08182733954010223,10020
2640,0.12739247548538146,7,0.03623232968719502,0.08181240258628825,10027
2689,0.06266214193303664,4,0.1006462515006564,0.08165419671684651,10031
764,0.0855432051099686,2,0.0777106065994123,0.08162690585469046,10033
1406,0.1119894151939832,8,0.051156006769999166,0.08157271098199118,10041
2011,0.10108625217035935,3,0.06199014446408185,0.0815381983172206,10044
1936,0.07980148973016418,7,0.08310093769301315,0.08145121371158867,10051
1200,0.09384396894100006,6,0.06886923366924863,0.08135660130512434,10057
335,0.09606479129553235,9,0.06649946658181885,0.08128212893867559,10066
833,0.08357887464184834,5,0.07886434066036903,0.08122160765110868,10071
621,0.05479127295387885,2,0.10759940428285333,0.08119533861836609,10073
542,0.05593148776583372,8,0.10640823736707992,0.08116986256645682,10081
1817,0.09456332030553237,6,0.0677588147688655,0.08116106753719893,10087
1644,0.10752112784178779,7,0.05475490838308783,0.08113801811243782,10094
2679,0.0677441132176862,5,0.09451769103456388,0.08113090212612503,10099
2073,0.08919640821044976,10,0.07304620551172049,0.08112130686108512,10109
1493,0.07595636928509657,10,0.08603807990844993,0.08099722459677325,10119
996,0.044021323145909105,6,0.11763943069975376,0.08083037692283143,10125
1704,0.09701083091178798,8,0.06400750796116608,0.08050916943647704,10133
2049,0.09022373046676553,1,0.07078419157065587,0.0805039610187107,10134
1384,0.08249962180993858,9,0.07847798012315409,0.08048880096654634,10143
2426,0.08791394877838962,8,0.07252481931963112,0.08021938404901037,10151
73,0.09621155161786316,7,0.06419333534757742,0.08020244348272029,10158
1780,0.06552509714404413,5,0.0948468327794162,0.08018596496173017,10163
2619,0.08930930076608885,5,0.07077215958160764,0.08004073017384825,10168
2227,0.14778493516580524,5,0.012019957059167974,0.0799024461124866,10173
2564,0.08903835863255505,2,0.07075611692954334,0.0798972377810492,10175
164,0.1136656438601125,5,0.04610952318564289,0.0798875835228777,10180
492,0.10594514776506604,4,0.05381641323732697,0.07988078050119651,10184
1664,0.0914158758543144,7,0.06797940123474946,0.07969763854453193,10191
279,0.11853944127216355,5,0.040722935377523715,0.07963118832484363,10196
2229,0.07927992612311159,8,0.07961567153204653,0.07944779882757906,10204
949,0.09790945565467514,6,0.060920634326462615,0.07941504499056888,10210
880,0.11052406982178778,2,0.048079828236671895,0.07930194902922984,10212
1796,0.11735181158684026,6,0.04114539188188329,0.07924860173436177,10218
2404,0.06728170530978844,9,0.09117440234436623,0.07922805382707734,10227
2487,0.09637863260020901,5,0.061776242436557986,0.0790774375183835,10232
1300,0.07051946380551771,3,0.08762630246281446,0.07907288313416608,10235
887,0.07931830959202886,4,0.07872664123015055,0.0790224754110897,10239
1596,0.08793652728951744,3,0.07008232554284323,0.07900942641618033,10242
2643,0.0640552360696231,6,0.09370513070750768,0.0788801833885654,10248
1398,0.064863546767999,3,0.0928147635179397,0.07883915514296935,10251
1782,0.10665185516336678,3,0.050785688884848516,0.07871877202410765,10254
1773,0.09971122084267511,6,0.05771210391360496,0.07871166237814003,10260
800,0.05796355376733747,7,0.09841097531303224,0.07818726454018485,10267
1726,0.09742627551653983,8,0.05861851375523725,0.07802239463588855,10275
2315,0.07259217112705155,7,0.0834431809370513,0.07801767603205143,10282
1152,0.08312730441929195,7,0.07284433547324487,0.07798581994626841,10289
1107,0.07745784027509654,3,0.07847664323548206,0.0779672417552893,10292
565,0.09321989889342713,4,0.06225752199848664,0.07773871044595689,10296
2179,0.07174999266198386,4,0.0834044111945626,0.07757720192827322,10300
1178,0.11614611909261476,2,0.03879380646679305,0.0774699627797039,10302
1552,0.06196085337740656,7,0.09256904356382167,0.07726494847061412,10309
236,0.09317474187117153,5,0.06123212915404421,0.07720343551260787,10314
215,0.10469881395081043,3,0.04916671791402742,0.07693276593241893,10317
559,0.093138616253367,3,0.06071074296195484,0.07692467960766092,10320
1063,0.062045748579247176,8,0.09159926524653546,0.07682250691289132,10328
2424,0.08478908283829945,2,0.06863046553102516,0.0767097741846623,10330
1868,0.1002657490759743,8,0.05314663251364293,0.07670619079480862,10338
668,0.10527456598456977,5,0.04803170028047903,0.0766531331325244,10343
742,0.09240933034393845,3,0.0607080691866108,0.07655869976527463,10346
1598,0.08971797181750238,10,0.06311580388392607,0.07641688785071422,10356
2034,0.10037367435916535,7,0.05221589131637981,0.07629478283777258,10363
133,0.10267352150264503,4,0.049881952818560275,0.07627773716060265,10367
1672,0.07223768850234477,7,0.08007288711587873,0.07615528780911175,10374
2690,0.07387237270799887,8,0.07810766223800343,0.07599001747300116,10382
1014,0.06737653505652527,5,0.08445841343518633,0.07591747424585579,10387
907,0.08965610669701218,8,0.061784263762590136,0.07572018522980116,10395
754,0.10374825863232921,3,0.04757849535966289,0.07566337699599605,10398
1139,0.09020115195563772,1,0.06088587524699,0.07554351360131385,10399
1461,0.06987823408948765,8,0.08089640992184555,0.0753873220056666,10407
47,0.0770898105437131,4,0.07367320582989975,0.07538150818680642,10411
2228,0.035306017850570894,6,0.11490148474744855,0.07510375129900972,10417
977,0.09331698649127676,6,0.05685248514049353,0.07508473581588515,10423
689,0.12068439982930643,2,0.0294797100558017,0.07508205494255406,10425
412,0.07450231316846502,6,0.07565581024751138,0.0750790617079882,10431
2343,0.09556580619960751,3,0.05418272045946155,0.07487426332953454,10434
2472,0.06786648874799896,8,0.08174667048125281,0.07480657961462589,10442
2620,0.08673535049751746,6,0.06274147533575934,0.07473841291663841,10448
718,0.09153102626106628,8,0.05793269037948893,0.07473185832027761,10456
1898,0.10465817263078035,7,0.04463466870586599,0.07464642066832317,10463
250,0.10869521042043442,10,0.0400825661826242,0.07438888830152932,10473
1499,0.06837450524837489,7,0.08008892976794303,0.07423171750815896,10480
2737,0.08213836563189347,10,0.06614652823640452,0.074142446934149,10490
486,0.0947349169901038,3,0.05342203137407988,0.07407847418209185,10493
1016,0.06698366896290121,1,0.08102876180137591,0.07400621538213856,10494
2129,0.07192836289989363,8,0.07588308115175546,0.07390572202582454,10502
64,0.06303242951553285,2,0.08471589800081818,0.07387416375817552,10504
1320,0.09385209720500605,5,0.05381240257431089,0.07383224988965847,10509
2151,0.10133913149499087,2,0.04594615551212156,0.07364264350355622,10511
1375,0.08949670240844976,8,0.05719740215987571,0.07334705228416273,10519
1519,0.06691141772729223,9,0.07966379948823941,0.07328760860776581,10528
1878,0.08637635217058516,8,0.06009844840816784,0.0732374002893765,10536
392,0.06714171854079595,4,0.07929882915377684,0.0732202738472864,10540
1093,0.07663598247004393,4,0.06962109929599494,0.07312854088301943,10544
2447,0.08499680514067538,4,0.06117063232113112,0.07308371873090325,10548
2707,0.10285414959166758,3,0.04319484068309611,0.07302449513738185,10551
1991,0.054434532478059315,4,0.09146183319385137,0.07294818283595535,10555
449,0.07486085992517481,7,0.07079515404956645,0.07282800698737063,10562
2497,0.07349982727438985,4,0.07203017088098222,0.07276499907768604,10566
884,0.07567413789599883,4,0.0698296537728307,0.07275189583441477,10570
1818,0.07920767488750254,6,0.06618930864190928,0.07269849176470591,10576
1402,0.10802462863993818,5,0.037284460285077925,0.07265454446250805,10581
2425,0.06992790681396888,10,0.07507025344716486,0.07249908013056687,10591
687,0.06403265755849527,8,0.08014507905016803,0.07208886830433164,10599
206,0.07323114299196883,5,0.07092857543923443,0.07207985921560163,10604
819,0.0435833000300294,1,0.10056336446499091,0.07207333224751016,10605
180,0.08974958173308135,9,0.05386988874420793,0.07180973523864465,10614
1812,0.0637413947649464,3,0.07963839862247094,0.07168989669370868,10617
1470,0.06713946068968317,7,0.07613842669711204,0.0716389436933976,10624
743,0.053472687904014216,4,0.08976131207503682,0.07161699998952552,10628
1239,0.07238444882467558,5,0.07063847081440523,0.07151145981954041,10633
750,0.08237092429651001,3,0.06062518215094531,0.07149805322372765,10636
1779,0.0747109386112861,7,0.0682772598080764,0.07149409920968125,10643
1624,0.07980148973016418,5,0.06314788918805464,0.07147468945910941,10648
1238,0.062343784926134405,6,0.08030550557081091,0.07132464524847265,10654
1254,0.036445329522080655,8,0.10595850835421106,0.07120191893814586,10662
1676,0.10634523898225096,6,0.03563313663259387,0.07098918780742242,10668
2044,0.10451547644045252,4,0.037446491070927235,0.07098098375568987,10672
769,0.09777624243902103,2,0.04404109057948733,0.07090866650925418,10674
217,0.010862521703593815,5,0.1307716783020457,0.07081710000281975,10679
2352,0.06736298794984859,4,0.0742494044165421,0.07080619618319534,10683
2161,0.100054414211818,3,0.041329882380622615,0.07069214829622031,10686
2311,0.06936795973799893,2,0.07201145445357389,0.07068970709578641,10688
1360,0.06842417797285609,4,0.07249941845386267,0.07046179821335938,10692
1031,0.05445936884029992,10,0.0863977026922244,0.07042853576626215,10702
2287,0.08057141695962283,5,0.06001288759715831,0.07029215227839057,10707
694,0.0797856847723747,7,0.060696037197562586,0.07024086098496865,10714
1287,0.07319501737416431,10,0.06711978246163801,0.07015739991790115,10724
1865,0.07295116945398383,3,0.0671919743959273,0.07007157192495557,10727
999,0.08104330784219427,6,0.058885891289642056,0.06996459956591816,10733
2322,0.09549355496399853,9,0.0442737090344195,0.06988363199920902,10742
1968,0.06279987085091635,3,0.07687772557974133,0.06983879821532885,10745
1775,0.08192161192506643,9,0.057752210543765684,0.06983691123441606,10754
760,0.0726711959159989,4,0.06699545190813977,0.06983332391206934,10758
1170,0.06231217501055546,10,0.07713440801276997,0.0697232915116627,10768
147,0.018923050176225264,4,0.12011267289299818,0.06951786153461172,10772
2411,0.08426977708235961,4,0.05458779742408483,0.06942878725322221,10776
1073,0.038984057313292644,10,0.09970240880420744,0.06934323305875004,10786
673,0.07482744372870562,7,0.06378825838295417,0.0693078510558299,10793
41,0.08789814382060016,5,0.05058916639706098,0.06924365510883057,10798
437,0.0910771981873971,8,0.0471731510175052,0.06912517460245116,10806
1322,0.08290829286135211,1,0.055226829731312314,0.06906756129633221,10807
2409,0.08975409743530688,4,0.04768705063863124,0.06872057403696906,10811
1669,0.05872670744345776,8,0.07850739165193861,0.06861704954769818,10819
1545,0.0750441974355327,7,0.06173479891872525,0.06838949817712897,10826
1234,0.07257185046703647,5,0.06391793648714048,0.06824489347708848,10831
1210,0.06631986073574336,10,0.06970398633166043,0.06801192353370189,10841
2662,0.06086037674503666,6,0.07500207217589162,0.06793122446046414,10847
2750,0.068911873813217,2,0.06686443691628141,0.06788815536474921,10849
1982,0.08118103676007395,1,0.054476835747306836,0.0678289362536904,10850
2212,0.06324240966902162,8,0.07241118386750907,0.06782679676826533,10858
2655,0.08542579685210394,5,0.050137298363916866,0.0677815476080104,10863
797,0.0854935323854874,8,0.04994746031448945,0.06772049634998842,10871
1443,0.0633801385869013,4,0.07203551843167033,0.0677078285092858,10875
1846,0.05200056897848038,6,0.0830207244326917,0.06751064670558604,10881
182,0.0671778441586005,3,0.06749143723446067,0.06733464069653058,10884
2053,0.07805391296887097,7,0.05660649780884109,0.06733020538885603,10891
274,0.08693404139544228,5,0.0475958748993992,0.06726495814742074,10896
443,0.08298505979918672,3,0.051458143383876595,0.06722160159153165,10899
2765,0.09196679152583316,5,0.04244217292374659,0.06720448222478988,10904
945,0.08880805781905127,7,0.045123969593826765,0.06696601370643901,10911
1785,0.08738561161799868,2,0.04640738175896985,0.06689649668848427,10913
222,0.07927766827199878,1,0.054408654476033616,0.06684316137401619,10914
1392,0.1184355801209756,6,0.014834105608778536,0.06663484286487707,10920
1158,0.08503518860959267,8,0.04792207549137306,0.06647863205048286,10928
703,0.05802225789626981,9,0.07491250070186603,0.06646737929906792,10937
1908,0.0794370725605612,9,0.05334957206225618,0.0663933223114087,10946
2036,0.08387916883984836,8,0.04886057063713393,0.06636986973849114,10954
2234,0.07660663040557777,3,0.05574687903572965,0.06617675472065371,10957
923,0.07020336464972826,8,0.061998165790113975,0.06610076521992111,10965
297,0.07347499091214924,7,0.05842867570580984,0.06595183330897954,10972
1281,0.08011126690283789,4,0.05175493244706593,0.06593309967495191,10976
2752,0.07292633309174323,9,0.058817710018368836,0.06587202155505603,10985
758,0.11201967039889447,8,0.019654922554097152,0.06583729647649582,10993
727,0.06426295837199901,3,0.06718261618222314,0.06572278727711107,10996
2325,0.09108848744296101,3,0.03987534859346047,0.06548191801821074,10999
120,0.06777165900126213,6,0.06279094017962422,0.06528129959044318,11005
220,0.07541448501802892,7,0.055095814739453956,0.06525514987874144,11012
630,0.06547542441956293,2,0.06474680684379537,0.06511111563167915,11014
178,0.062917279108781,9,0.06681764584776058,0.0648674624782708,11023
2545,0.0698488820250215,3,0.059209418106271866,0.06452915006564669,11026
2397,0.06494482940805918,1,0.06409039499683157,0.06451761220244537,11027
602,0.09247932372843469,3,0.036324574936564685,0.06440194933249968,11030
2366,0.11266451267670502,7,0.01604666272730432,0.06435558770200467,11037
1821,0.09737660279205866,3,0.031231032906153155,0.06430381784910591,11040
1574,0.08068205166414912,3,0.04775095386935399,0.06421650276675156,11043
48,0.040799369607969295,8,0.08683352807330422,0.06381644884063675,11051
61,0.08480262994497616,7,0.042738961986935935,0.06377079596595604,11058
2096,0.05972919333753294,10,0.06749010034678866,0.0636096468421608,11068
1482,0.09947414647583303,9,0.027712344553385934,0.06359324551460949,11077
775,0.08290829286135211,6,0.04418146378504985,0.06354487832320098,11083
2279,0.04902472121183385,10,0.07794990949270458,0.06348731535226922,11093
2658,0.06796583419696135,2,0.058976799651339694,0.06347131692415052,11095
1838,0.057810019891668285,4,0.06905292203538474,0.06343147096352651,11099
958,0.06734492514094635,7,0.0594179725831076,0.06338144886202698,11106
647,0.09672859952269025,5,0.029463667403737404,0.06309613346321383,11111
2063,0.06447745422771328,8,0.06169201851322048,0.06308473637046688,11119
824,0.05317239370601423,4,0.0729031585308139,0.06303777611841407,11123
1168,0.06804260113479597,6,0.05793803793017703,0.0629903195324865,11129
667,0.05629725964610442,2,0.06934436354788598,0.06282081159699521,11131
934,0.05113806985339771,2,0.07447533843311417,0.06280670414325594,11133
2218,0.07404171154145753,6,0.05141001542768371,0.06272586348457063,11139
1872,0.06895206356302451,1,0.05643724782956286,0.06269465569629368,11140
224,0.08523162165640473,8,0.0399208027743093,0.06257621221535702,11148
1111,0.090239535424555,10,0.03470266281286515,0.06247109911871007,11158
915,0.05694300506436002,4,0.06772004502637678,0.0623315250453684,11162
143,0.07438038920837482,7,0.05008248596936388,0.06223143758886935,11169
2288,0.07551157261587854,4,0.048694796565802945,0.06210318459084074,11173
1530,0.06529028062831478,2,0.05890861838006646,0.06209944950419062,11175
665,0.0808897739665251,5,0.043295107258497924,0.06209244061251151,11180
2393,0.07226026701347259,9,0.05165600275933615,0.061958134886404365,11189
2490,0.08876741649902119,6,0.03501041435496507,0.061888915426993124,11195
264,0.06876511349088618,6,0.0549647997475956,0.06186495661924089,11201
2022,0.05036362692171353,5,0.07309567035558538,0.06172964863864945,11206
2239,0.08012029830728899,7,0.04318280869404792,0.061651553500668456,11213
720,0.07438490491060036,4,0.04884853864808571,0.061616721779343034,11217
586,0.07011756630744254,9,0.05285118033812563,0.061484373322784086,11226
1781,0.06218121964601408,1,0.06074951270444355,0.06146536617522881,11227
2471,0.06156256844111185,5,0.06129496287462936,0.06142876565787061,11232
2634,0.05710105464225477,8,0.0655836985264824,0.061342376584368585,11240
2214,0.08137972765799875,6,0.040654754106250475,0.06101724088212461,11246
2092,0.04540764372915721,2,0.07636302382601208,0.06088533377758465,11248
2192,0.05953276029072088,3,0.061954048496937204,0.06074340439382904,11251
2142,0.07220607858676581,4,0.048839180434381534,0.060522629510573675,11255
1938,0.07387237270799887,4,0.04694614749079552,0.0604092600993972,11259
160,0.07458133795741238,6,0.046000967906674545,0.060291152932043464,11265
2144,0.07844452121138228,6,0.04198362045224235,0.06021407083181231,11271
316,0.06814420443487117,5,0.052258939099418984,0.06020157176714508,11276
1455,0.06267117333748776,8,0.057549003617618034,0.06011008847755289,11284
548,0.07911736084299129,10,0.04059192038566536,0.059854640614328325,11294
1502,0.09022373046676553,1,0.02938211725574394,0.059802923861254735,11295
1491,0.076728554365668,2,0.04275901530201629,0.05974378483384214,11297
768,0.04147672494180387,3,0.07797263658312903,0.05972468076246645,11300
1665,0.06050137841810433,3,0.058852469097841455,0.05967692375797289,11303
1987,0.07438490491060036,2,0.04484456007037377,0.059614732490487064,11305
785,0.06679400946942755,2,0.05203835263353502,0.05941618105148129,11307
2338,0.05976306110422465,3,0.058976799651339694,0.05936993037778217,11310
974,0.08916254044375803,1,0.02927650312965404,0.05921952178670603,11311
2509,0.04368264547899181,6,0.07471731510175053,0.05919998029037117,11317
112,0.055051377402071326,5,0.06237623762376239,0.058713807512916855,11322
747,0.07123746045938235,4,0.04611861402181265,0.0586780372405975,11326
869,0.018837251833939552,5,0.09839493266096795,0.058616092247453754,11331
2685,0.013456792632180244,1,0.10358205682842116,0.0585194247303007,11332
37,0.07216092156451016,2,0.0448632764977821,0.05851209903114613,11334
33,0.05257857886335257,1,0.06439654227372507,0.05848756056853882,11335
524,0.09980830844052474,3,0.017134889292331874,0.058471598866428304,11338
2718,0.0754167428691417,8,0.04139004232586369,0.0584033925975027,11346
2414,0.07213382735115681,6,0.04458386697432907,0.058358847162742936,11352
155,0.06745781769658542,5,0.04909987353042622,0.05827884561350582,11357
521,0.06554315995294636,3,0.050547722879228235,0.0580454414160873,11360
931,0.05871090248566827,5,0.057258898992788826,0.057984900739228545,11365
1445,0.07305051490294627,4,0.04277372106640855,0.05791211798467741,11369
2165,0.0941975484252617,9,0.021388865864712316,0.05779320714498701,11378
212,0.04621595442753314,9,0.06882297735579661,0.05751946589166487,11387
1896,0.065940541748796,10,0.049065114450953594,0.057502828099874795,11397
31,0.059577465742753966,1,0.05505223220134597,0.05731484897204997,11398
1323,0.06438036662986367,4,0.05020280585984604,0.05729158624485485,11402
1282,0.07838130138022435,7,0.03617484351729799,0.057278072448761166,11409
247,0.05545959688326231,3,0.058852469097841455,0.057156032990551886,11412
2553,0.07244089510249514,4,0.041852605460384,0.057146750281439576,11416
67,0.06562218474189373,2,0.04856912912463269,0.05709565693326321,11418
458,0.07131874309944254,6,0.04265607495127044,0.05698740902535649,11424
1267,0.07843774765804391,5,0.03549570457990978,0.05696672611897685,11429
1355,0.057286198433502876,5,0.0564794934799988,0.05688284595675084,11434
1028,0.05654110756628486,10,0.05720007593521977,0.05687059175075232,11444
738,0.08402367131106638,5,0.029598693058611826,0.056811182184839104,11449
1766,0.06627018801126214,1,0.04724694721700093,0.05675856761413153,11450
1411,0.04285175626948806,10,0.06973206097277294,0.0562919086211305,11460
1414,0.07956215751220932,7,0.03289946872083914,0.05623081311652423,11467
2463,0.09087624943835951,7,0.021249829546821815,0.05606303949259066,11474
12,0.07757299068184842,7,0.034178870222966125,0.05587593045240727,11481
571,0.1041388668748405,2,0.007207161439881498,0.055673014157361,11483
2149,0.05111097564004432,4,0.06018267233150536,0.055646823985774835,11487
244,0.05428099860239016,10,0.0568511482528215,0.05556607342760583,11497
2516,0.07580057755831462,4,0.03526442301264963,0.05553250028548212,11501
2095,0.07316340745858534,5,0.03744622369339283,0.05530481557598908,11506
1805,0.06307532868667574,3,0.047498282099341434,0.05528680539300859,11509
2530,0.0585573686099991,4,0.052014288655438584,0.055285828632718845,11513
900,0.07881255094276571,4,0.03150375799124606,0.05515815446700588,11517
421,0.06521351369048023,10,0.044685470437402904,0.05494949206394156,11527
121,0.05792742814953294,3,0.05193808605813322,0.05493275710383308,11530
1512,0.06932957626908166,8,0.040518391563704036,0.054923983916392846,11538
283,0.08209998216297618,7,0.02768159613692938,0.05489078914995278,11545
1944,0.056430472861758535,3,0.05326561551645308,0.054848044189105806,11548
1181,0.0429217496539843,10,0.06656363719007602,0.054742693422030156,11558
604,0.050433620306209764,5,0.058864501086889676,0.05464906069654972,11563
2174,0.06672627393604409,4,0.04236463343876919,0.05454545368740664,11567
615,0.012445275333653945,5,0.09656072277495102,0.05450299905430248,11572
1286,0.04671719737457073,7,0.06226821709986283,0.054492707237216775,11579
914,0.08951928091957757,2,0.019287278444290554,0.054403279681934064,11581
2100,0.05976306110422465,1,0.04856912912463269,0.05416609511442867,11582
1439,0.07211486140180942,8,0.03619864011786001,0.05415675075983471,11590
1734,0.07194416785768311,5,0.03614008443782536,0.054042126147754235,11595
2135,0.0792392848030815,4,0.028505118942896174,0.053872201872988836,11599
1339,0.09083335026721664,4,0.016887565073007434,0.053860457670112036,11603
2434,0.055527332416645786,6,0.05216936762539338,0.05384835002101958,11609
464,0.05702654555553295,9,0.05051029002441156,0.05376841778997225,11618
2124,0.0752564354401342,10,0.031502421103574034,0.053379428271854115,11628
175,0.0638610608739238,7,0.042884682743186554,0.05337287180855518,11635
97,0.03786642101246559,6,0.06858233757483229,0.05322437929364894,11641
1451,0.052745659845698435,3,0.05365331294134004,0.053199486393519235,11644
1306,0.05679850259314198,4,0.049426074122400084,0.05311228835777103,11648
2090,0.05799516368291642,3,0.0478739475351802,0.052934555609048306,11651
1358,0.018040230391127544,2,0.08759020649566981,0.052815218443398676,11653
414,0.07303245209404399,5,0.03251043440828015,0.05277144325116207,11658
1145,0.0635652823781494,4,0.04164137720820421,0.052603329793176806,11662
233,0.05859123637669083,3,0.04627904054245553,0.05243513845957318,11665
2476,0.07188320587763798,6,0.03274305286321232,0.05231312937042515,11671
2086,0.04596307510290155,4,0.058615839979893204,0.052289457541397376,11675
452,0.0672388061386456,7,0.03729916604947018,0.05226898609405789,11682
625,0.035197640997157345,4,0.0692066641176675,0.05220215255741242,11686
2720,0.058340614903172036,2,0.046058454076571574,0.0521995344898718,11688
1609,0.05917150411267578,2,0.04511461138012261,0.0521430577463992,11690
1015,0.0757057478115778,4,0.028444958997655093,0.05207535340461644,11694
1916,0.09310249063556247,4,0.01076863019815349,0.051935560416857984,11698
2579,0.038293154872781364,3,0.06556899276209015,0.05193107381743575,11701
2369,0.05479127295387885,6,0.048978216752272034,0.05188474485307544,11707
2712,0.05772873725160814,2,0.04593144974772929,0.05183009349966872,11709
2357,0.05304143834147288,6,0.04984719373908765,0.05144431604028027,11715
901,0.0414609199840144,7,0.06127892022256508,0.05136992010328974,11722
2126,0.046484638709954174,5,0.056213452833266044,0.051349045771610105,11727
1122,0.0515512566070368,3,0.051141301005606904,0.05134627880632185,11730
493,0.07653437916996875,6,0.026102731796269013,0.05131855548311888,11736
1336,0.0689750936443749,2,0.033633420052780326,0.05130425684857762,11738
225,0.06679400946942755,1,0.03538607979080381,0.05109004463011568,11739
816,0.06666531195599897,3,0.035505062793613956,0.05108518737480646,11742
2099,0.04221955795790914,5,0.059825723323074946,0.05102264064049204,11747
210,0.04285401412060086,7,0.058947388122555164,0.05090070112157801,11754
1839,0.07141131499506659,8,0.03034066571658516,0.05087599035582587,11762
2204,0.07438490491060036,2,0.027227054328441212,0.05080597961952078,11764
2581,0.05978112391312689,7,0.041796456178159,0.05078879004564295,11771
1077,0.05448646305365329,3,0.04705710916757351,0.0507717861106134,11774
2609,0.06327853528682609,1,0.03816145859792568,0.05071999694237589,11775
1106,0.0570581554711119,2,0.044186811335737944,0.05062248340342492,11777
1231,0.031048613792309308,4,0.07011601511217824,0.05058231445224377,11781
682,0.06899541430438993,7,0.03177514618866693,0.050385280246528434,11788
1565,0.062212829561593026,1,0.038438194346034654,0.05032551195381384,11789
62,0.06101616847181863,7,0.03960797105905567,0.050312069765437145,11796
203,0.060027229684420126,8,0.04050769646232784,0.050267463073373986,11804
2040,0.06093488583175846,2,0.039549148001486616,0.05024201691662254,11806
540,0.04827511464239023,5,0.052160009411689204,0.05021756202703972,11811
2651,0.06535575831058547,5,0.03471095151643167,0.050033354913508576,11816
2262,0.059259560306074294,5,0.04022293938818672,0.049741249847130506,11821
2403,0.0465930155633677,3,0.05283914834907741,0.049716081956222555,11824
818,0.0676610242967358,9,0.031597340128287736,0.049629182212511766,11833
365,0.045179600766766234,8,0.05402363082649069,0.04960161579662846,11841
2528,0.06312725926226971,5,0.035993026793902726,0.049560143028086215,11846
2285,0.04970659224789397,3,0.04916805480169945,0.04943732352479671,11849
902,0.049040526169623316,8,0.049732221399293564,0.04938637378445844,11857
189,0.05070004673751802,8,0.04804640604487128,0.04937322639119465,11865
213,0.04662914118117221,9,0.052066427274647525,0.04934778422790986,11874
998,0.06626341445792379,1,0.03241150472055037,0.049337459589237076,11875
415,0.05225119045199919,1,0.04640738175896985,0.049329286105484524,11876
986,0.06822774492604408,8,0.03040751010018636,0.04931762751311522,11884
2259,0.07851225674476574,4,0.02012149635163354,0.04931687654819964,11888
2150,0.050526192201833825,3,0.048089186450376076,0.04930768932610495,11891
1745,0.05917150411267578,3,0.03935529928904313,0.04926340170085945,11894
563,0.05229634747425483,7,0.04618946906842993,0.04924290827134238,11901
2051,0.04687298910135266,6,0.05134450793175455,0.049108748516553606,11907
1333,0.05592922991472094,1,0.04223495533458287,0.04908209262465191,11908
476,0.07021013820306658,5,0.027926246580909777,0.04906819239198818,11913
623,0.06913765892449518,5,0.028975703403448634,0.04905668116397191,11918
199,0.04410486363708203,2,0.053908658486696626,0.04900676106188932,11920
2141,0.0539761887021646,6,0.04391996855640195,0.04894807862928327,11926
1978,0.06674885244717191,4,0.030977024248468602,0.04886293834782025,11930
696,0.050388463283954105,2,0.04728839073483367,0.04883842700939389,11932
1799,0.0688486539820591,8,0.02872436852110811,0.048786511251583606,11940
1024,0.04962756745894661,3,0.04779239738718672,0.048709982423066664,11943
1091,0.05344559369066083,4,0.04393093103531253,0.04868826236298668,11947
211,0.06838127880171326,6,0.02815752814816993,0.04826940347494159,11953
692,0.05148126322254058,7,0.04467477533602671,0.04807801927928365,11960
196,0.043409445494345195,4,0.05247016735159878,0.04793980642297199,11964
722,0.051876387167277396,2,0.043674783357352746,0.04777558526231507,11966
356,0.044868017313202314,7,0.05058248195870086,0.04772524963595159,11973
1890,0.04210440755115725,4,0.053323101686350106,0.04771375461875368,11977
980,0.04969756084344286,3,0.04563198690919591,0.047664773876319386,11980
1607,0.05026879717497667,3,0.044944826645775565,0.04760681191037612,11983
1436,0.053660089546375134,6,0.041154750095587465,0.0474074198209813,11989
1920,0.07759105349075068,6,0.017135156669866283,0.047363105080308485,11995
749,0.05989175861765321,6,0.03477378523701681,0.04733277192733501,12001
2203,0.06846707714399893,4,0.026031609372117334,0.04724934325805813,12005
1464,0.029756219815352928,4,0.06411044831191193,0.046933334063632426,12009
894,0.060838249804131404,5,0.03295080520744485,0.046894527505788125,12014
1862,0.08396045147990848,4,0.009816766175672386,0.04688860882779043,12018
1690,0.06122163292308176,3,0.03241150472055037,0.04681656882181606,12021
1510,0.07150840259291619,1,0.02209073189252492,0.04679956724272055,12022
1961,0.05710782819559311,5,0.03632056427354861,0.04671419623457086,12027
135,0.0686973779575027,9,0.024657556222811045,0.046677467090156875,12036
2132,0.04804481382888648,2,0.04509990561573035,0.046572359722308415,12038
2292,0.04287072221883544,6,0.05022606770533926,0.04654839496208735,12044
53,0.04727940230165341,9,0.045809792969575096,0.04654459763561425,12053
957,0.05545056547881118,3,0.037637398630492265,0.046543982054651725,12056
2492,0.047058132892600774,9,0.04595016617513761,0.046504149533869193,12065
1864,0.06516384096599899,9,0.027737745419154393,0.046450793192576695,12074
114,0.06086037674503666,4,0.03203182862169555,0.0464461026833661,12078
2353,0.0658524855553975,3,0.026919570163875688,0.046386027859636594,12081
788,0.06351560965366822,3,0.02907195931583436,0.046293784484751285,12084
2727,0.05042007319953307,6,0.042052069101049985,0.04623607115029153,12090
1769,0.0499662451258639,6,0.042464900014171005,0.04621557257001745,12096
1066,0.04797256259327745,8,0.04438868137421359,0.04618062198374552,12104
2622,0.05278404331461575,8,0.039523747135718164,0.046153895225166955,12112
1426,0.056376284435051785,2,0.03585131670066817,0.04611380056785998,12114
2714,0.06251086590848026,4,0.029654842340836835,0.04608285412465855,12118
547,0.06491773519470577,8,0.027227054328441212,0.04607239476157349,12126
825,0.055606357205593156,4,0.036497033446255774,0.046051695325924465,12130
874,0.0556108729078187,9,0.03647698013117542,0.046043926519497055,12139
287,0.05533902763383975,10,0.03670050774993783,0.046019767691888785,12149
307,0.0671259135830065,5,0.024780549888637253,0.04595323173582187,12154
1151,0.04413421570154819,3,0.04744079592944441,0.0457875058154963,12157
2251,0.05743521660694649,8,0.03405186589412384,0.04574354125053516,12165
1743,0.04356297937001438,10,0.04751031408838966,0.04553664672920202,12175
723,0.06430721225380956,7,0.026596578102314687,0.04545189517806213,12182
1035,0.03223534033718748,6,0.05866129416074204,0.04544831724896476,12188
2170,0.026994867904420645,10,0.06343398314986777,0.045214425527144206,12198
924,0.05465128618488638,5,0.035736344360874105,0.045193815272880244,12203
1640,0.049945924465848876,6,0.040299141985492094,0.04512253322567049,12209
1949,0.044075511572615876,10,0.04595283995048168,0.04501417576154878,12219
2692,0.04074292333014975,3,0.04903436603449705,0.0448886446823234,12222
725,0.08378433909311149,4,0.005601559345780649,0.04469294921944607,12226
281,0.056669805079713434,6,0.032463643339759304,0.04456672420973637,12232
2030,0.057575203375938966,4,0.031514453092622255,0.04454482823428061,12236
166,0.025698861365683816,6,0.06329762060732134,0.04449824098650258,12242
1096,0.053766208548675865,7,0.035019772568669234,0.044392990558672546,12249
1365,0.039774305202766314,7,0.04880709513025296,0.04429070016650964,12256
1979,0.042625971158209874,2,0.04572957970925366,0.04417777543373177,12258
1044,0.05549572250106682,10,0.0322684577396438,0.04388209012035531,12268
1459,0.036626860751548314,4,0.050792373323208635,0.043709617037378475,12272
469,0.04398068182587903,5,0.04326703261738542,0.04362385722163223,12277
1715,0.05090054391633307,3,0.03627243631735574,0.0435864901168444,12280
1310,0.059458251203999085,4,0.027204327238016808,0.04333128922100794,12284
776,0.043553947965563236,7,0.043102595433726465,0.04332827169964485,12291
2336,0.06725686894754784,2,0.019272572679898285,0.04326472081372307,12293
289,0.0477445196308865,4,0.038776426927056726,0.04326047327897162,12297
771,0.03782352184132273,7,0.04865602682331425,0.04323977433231849,12304
2274,0.04719811966159326,5,0.03918551455469608,0.04319181710814467,12309
1315,0.04868830139602933,1,0.037637398630492265,0.0431628500132608,12310
197,0.055191364171063816,6,0.030850287297160713,0.04302082573411226,12316
639,0.036326566553548316,2,0.049262973826413155,0.042794770189980735,12318
1788,0.04463094294636022,2,0.04084058149266182,0.04273576221951102,12320
1030,0.04403712810369858,4,0.04122560514220473,0.04263136662295165,12324
109,0.058557368609999105,5,0.02667090905687922,0.04261413883343916,12329
2744,0.052434076392134536,5,0.03260401654532183,0.042519046468728186,12334
34,0.048708622056044364,9,0.03620425504608252,0.042456438551063444,12343
2190,0.0542742250490518,6,0.030538525092044716,0.04240637507054826,12349
2681,0.04561310818042035,1,0.039126691497127025,0.04236989983877369,12350
172,0.05286984165690144,6,0.03171097558040977,0.0422904086186556,12356
1873,0.0352315087638491,8,0.04934051331139054,0.04228601103761982,12364
662,0.06084005608502162,3,0.023215321802231532,0.04202768894362657,12367
2508,0.04429452313055571,2,0.03961331860974378,0.04195392087014974,12369
981,0.04166051402238433,6,0.0417576864356703,0.04170910022902732,12375
2238,0.035387300490631046,10,0.04790335906396472,0.04164532977729789,12385
1899,0.059334069392796104,4,0.023922268003197834,0.04162816869799697,12389
406,0.03747129706772876,5,0.045291080552829786,0.041381188810279274,12394
2060,0.04452933964628503,2,0.03816145859792568,0.04134539912210536,12396
2730,0.05205927310741273,3,0.030452964281035177,0.04125611869422395,12399
2536,0.04561310818042035,3,0.03670291414774746,0.04115801116408391,12402
2547,0.04552956768924744,5,0.036522434312024246,0.041026001000635845,12407
1975,0.04443225204843541,6,0.037546490268794634,0.04098937115861502,12413
685,0.05054425501073608,5,0.030995740675876928,0.0407699978433065,12418
1052,0.03783706894799942,5,0.043525051938086055,0.04068106044304273,12423
2198,0.04804481382888648,10,0.033304545685462414,0.040674679757174446,12433
1019,0.041454146430676055,1,0.03988604369483667,0.04067009506275636,12434
710,0.026105274565984563,9,0.05512388938056646,0.04061458197327551,12443
1313,0.016760028810180193,8,0.06444333334224593,0.040601681076213064,12451
1592,0.051025177297758614,9,0.030160185880861917,0.040592681589310266,12460
1540,0.019844253430240294,3,0.061205391400603756,0.040524822415422025,12463
1190,0.054156816791187154,6,0.026878126646042944,0.04051747171861505,12469
1119,0.04327397442757828,2,0.03774167586891014,0.040507825148244206,12471
1867,0.058306747136480284,5,0.02268965756959169,0.040498202353035986,12476
882,0.06086037674503666,1,0.020019892888559716,0.04044013481679819,12477
864,0.052497296223292425,4,0.028307259567436613,0.04040227789536452,12481
2358,0.043754896714600845,4,0.03704248361644158,0.04039869016552121,12485
1288,0.05734716041354799,6,0.023257834830201895,0.04030249762187494,12491
1885,0.045041871848886535,4,0.03548768325387765,0.040264777551382094,12495
1535,0.046845894887999284,1,0.03360534541166781,0.04022562014983355,12496
856,0.05859800993002918,7,0.021618275789231634,0.04010814285963041,12503
434,0.06679400946942755,4,0.013183049333828873,0.03998852940162821,12507
106,0.05078132937757816,3,0.028840677748574208,0.03981100356307619,12510
583,0.04598339576291658,1,0.033633420052780326,0.03980840790784845,12511
334,0.05695203646881113,3,0.02262415007366251,0.03978809327123682,12514
1658,0.007213834305338234,4,0.07235102392226801,0.03978242911380312,12518
509,0.0473674584950519,5,0.031855359448988374,0.03961140897202014,12523
1984,0.021002531051097416,5,0.05756905693269839,0.039285793991897903,12528
1201,0.05885992065911188,4,0.019695029184257872,0.039277474921684874,12532
1996,0.0500023707436684,3,0.028547899348400935,0.039275135046034665,12535
2454,0.042756926522751225,8,0.03574035502389018,0.0392486407733207,12543
1074,0.048794420398330075,8,0.0295358593380267,0.03916513986817839,12551
552,0.04537603381357825,1,0.03283797188792603,0.03910700285075214,12552
2565,0.029855565264315338,7,0.04824025475731479,0.03904791001081506,12559
1056,0.05672850920864575,5,0.020863469009606873,0.03879598910912631,12564
2596,0.03703327395184906,2,0.040510370237671886,0.038771822094760475,12566
857,0.0500407542125857,1,0.027227054328441212,0.038633904270513456,12567
94,0.03765418300786409,8,0.038988992066908555,0.03832158753738632,12575
2635,0.010629963038977277,7,0.0658176538690866,0.038223808454031935,12582
1160,0.04277453776143092,2,0.033516843447779825,0.038145690604605376,12584
395,0.029753961964240152,2,0.04644615150145854,0.038100056732849344,12586
1655,0.042410120591827916,4,0.03366791175471853,0.038039016173273224,12590
1528,0.030645813153789,3,0.045372630700823244,0.038009221927306124,12593
1146,0.04041553491879637,2,0.035416828207260366,0.03791618156302837,12595
1952,0.03834508544837535,1,0.03743151792900057,0.03788830168868796,12596
1199,0.045701164373818846,2,0.029835322176560077,0.03776824327518946,12598
230,0.059458251203999085,3,0.016002545434127532,0.03773039831906331,12601
354,0.028141856269713866,4,0.04710390023609436,0.03762287825290411,12605
2664,0.03295559484216492,4,0.041970251575522116,0.03746292320884352,12609
2016,0.05778653824009535,7,0.017107884161356994,0.03744721120072617,12616
855,0.017557050252992205,8,0.05706371339267331,0.03731038182283276,12624
573,0.037868678863578364,4,0.036382061106461715,0.03712536998502004,12628
1203,0.02573047128126277,2,0.048475546987591,0.037103009134426886,12630
1039,0.05181768303834508,5,0.022340729887193416,0.03707920646276925,12635
1891,0.008121490452676568,2,0.06572006106902888,0.036920775760852724,12637
967,0.04356749507223993,5,0.02987943946973687,0.0367234672709884,12642
955,0.042029898464435445,2,0.03132728881853889,0.036678593641487164,12644
1129,0.03550696659960848,5,0.037383389972807705,0.036445178286208094,12649
353,0.037227449147548296,2,0.035642762223832426,0.03643510568569036,12651
921,0.044278718172766234,5,0.028459664762047362,0.036369191467406796,12656
2486,0.06241377831063062,1,0.010078796159389095,0.03624628723500986,12657
1567,0.05801096864070588,4,0.013981171274027211,0.035996069957366546,12661
1895,0.03897502590884151,2,0.03281524479750162,0.03589513535317157,12663
382,0.0435833000300294,5,0.02820030855367469,0.03589180429185204,12668
2112,0.04144059932399938,5,0.030244409804199433,0.0358425045640994,12673
1503,0.04456320741297676,5,0.026999783424197128,0.03578149541858694,12678
1472,0.054120691173382626,4,0.017129541741643783,0.035625116457513206,12682
1114,0.030541952002601045,2,0.04062935324048202,0.035585652621541536,12684
49,0.05204572600073604,4,0.019065355090734565,0.0355555405457353,12688
1517,0.03776933341461596,4,0.03331390389916657,0.03554161865689127,12692
2042,0.032485961810706274,7,0.03847027965016324,0.035478120730434756,12699
654,0.009823910191714134,7,0.060948708967575135,0.035386309579644636,12706
1452,0.036617829347097196,9,0.0340104223762911,0.03531412586169415,12715
101,0.026872943944330416,8,0.04351034617369379,0.0351916450590121,12723
1117,0.02773770092052589,6,0.042621315871797814,0.03517950839616185,12729
1906,0.02642363157288682,2,0.04348360842025331,0.03495361999657007,12731
807,0.044863501610976755,3,0.02480595075440571,0.034834726182691234,12734
762,0.029187241334931883,7,0.040430156977350445,0.03480869915614117,12741
698,0.04209086044448056,3,0.02730459381341861,0.034697727128949585,12744
896,0.02566725145010487,6,0.04366408825597654,0.034665669853040704,12750
2457,0.024052887904465803,2,0.04527637478843752,0.03466463134645166,12752
1419,0.041984741442179806,7,0.026997109648853084,0.03449092554551644,12759
2599,0.018290851864646334,3,0.05068809608479076,0.03448947397471855,12762
1923,0.04101386546368358,1,0.027753788071218678,0.03438382676745113,12763
1555,0.04606242055186395,4,0.02236479386528985,0.0342136072085769,12767
11,0.0466562353945256,8,0.021705708242982007,0.034180971818753805,12775
485,0.0384399151951122,7,0.029796552434071383,0.034118233814591795,12782
659,0.007570574781157776,6,0.060593096846816755,0.034081835813987264,12788
2645,0.06202091221700656,7,0.006124282425542041,0.0340725973212743,12795
829,0.042341481917999364,2,0.025604072694604053,0.03397277730630171,12797
2554,0.03819471256426408,3,0.029698692256479226,0.03394670241037165,12800
2116,0.02747353234033041,4,0.0403833659088296,0.033928449124580005,12804
891,0.030458411511428106,3,0.037265743857669585,0.033862077684548846,12807
79,0.03890729037545804,2,0.028692283216979537,0.033799786796218784,12809
1570,0.04351330664553316,1,0.02400782881420737,0.03376056772987027,12810
1098,0.04295561742067603,6,0.024260500584219913,0.03360805900244797,12816
1317,0.04463094294636022,3,0.022422280035186884,0.03352661149077355,12819
2395,0.05978112391312689,3,0.007090852212415407,0.03343598806277115,12822
1910,0.04598339576291658,1,0.0208206886041021,0.03340204218350934,12823
2485,0.05998207266216449,1,0.00671919743959273,0.03335063505087861,12824
2617,0.044515792539608336,1,0.022106774544589217,0.03331128354209878,12825
475,0.03705359461186409,4,0.02956660775448325,0.033310101183173665,12829
2371,0.04974497571681126,2,0.01656804891939369,0.033156512318102474,12831
375,0.012612356315999804,2,0.05334181811375844,0.032977087214879124,12833
2197,0.01487472313100729,3,0.05076697245744019,0.03282084779422374,12836
1075,0.0461188668296835,5,0.01947979026906201,0.03279932854937275,12841
843,0.04972691290790901,5,0.0157391785627388,0.0327330457353239,12846
1120,0.029205304143834137,2,0.0361815279556581,0.03269341604974612,12848
116,0.06200510725921709,7,0.0033555880567802928,0.03268034765799869,12855
1548,0.030785799922781486,6,0.0344449108696989,0.03261535539624019,12861
1498,0.047335848579472956,2,0.01761750574193255,0.03247667716070275,12863
1134,0.031910209776946884,3,0.03274438975088435,0.032327299763915615,12866
46,0.03024165780460104,5,0.03439678291350604,0.03231922035905354,12871
2041,0.05051264509515711,5,0.013886252249313507,0.03219944867223531,12876
1433,0.04564246024488652,6,0.0187057323069601,0.03217409627592331,12882
472,0.0018040230391127544,3,0.06248612979040276,0.03214507641475776,12885
1937,0.03713713510303703,5,0.02689015863509116,0.0320136468690641,12890
1795,0.03702650039851072,4,0.026678930382911362,0.031852715390711044,12894
1326,0.0512012896845556,7,0.012273965716852539,0.03173762770070407,12901
1373,0.02875599177239053,6,0.03460132672732571,0.03167865924985812,12907
205,0.03813871785666709,8,0.02515969123242327,0.03164920454454518,12915
1934,0.03743065574769869,5,0.025185626853260534,0.03130814130047961,12920
2534,0.03123059659199952,8,0.03132461504319484,0.03127760581759718,12928
177,0.030329713997999542,5,0.03213476897244139,0.03123224148522047,12933
2663,0.03529021289278144,6,0.02710272377494298,0.03119646833386221,12939
2401,0.029729125601999543,7,0.032554551701456935,0.03114183865172824,12946
898,0.04414324710599932,4,0.01813621815867787,0.031139732632338595,12950
1881,0.035527287259623515,6,0.02663748686507862,0.03108238706235107,12956
1767,0.0396885068604806,2,0.02243163824889105,0.031060072554685826,12958
2591,0.035154741826014496,8,0.02674711165418459,0.03095092674009954,12966
2226,0.04324010666088655,6,0.01844102854789935,0.030840567604392948,12972
1265,0.04969756084344286,4,0.011941080686518557,0.030819320764980708,12976
1259,0.04944468151881127,2,0.012157656489386447,0.030801169004098856,12978
1921,0.04291949180287152,3,0.018629529709654733,0.030774510756263126,12981
2740,0.041440599323999364,1,0.019736472702090623,0.030588536013044995,12982
2585,0.01819376426679671,1,0.042562492814228754,0.030378128540512733,12983
674,0.0522624797075631,5,0.008469183402272174,0.030365831554917636,12988
1608,0.03421005692042654,5,0.026451659478667282,0.030330858199546912,12993
2427,0.0324918322235995,7,0.027917155744740012,0.030204493984169755,13000
2451,0.03333717168022506,6,0.026875452870698896,0.03010631227546198,13006
2573,0.006586151695984861,6,0.05361588008652336,0.03010101589125411,13012
2675,0.03460156830338293,7,0.025596051368571907,0.030098809835977416,13019
2729,0.0021607635149322978,6,0.058008892976794305,0.030084828245863303,13025
2345,0.032883343606555884,4,0.02720833790103288,0.030045840753794382,13029
488,0.02876050747461612,10,0.03125643377192161,0.030008470623268862,13039
480,0.039808172969458044,5,0.020170961195498435,0.02998956708247824,13044
2532,0.03635140291578893,8,0.023517191038574553,0.02993429697718174,13052
1299,0.042490500091442965,7,0.01718168036085272,0.029836090226147843,13059
251,0.031002553629608545,3,0.028466349200407484,0.029734451415008016,13062
258,0.04942436085879623,1,0.009577463282380088,0.029500912070588158,13063
87,0.021140259968977115,7,0.03784996377034408,0.029495111869660598,13070
1004,0.03241145272398448,6,0.02612144822367735,0.02926645047383091,13076
495,0.015233721457939615,5,0.04301302395970086,0.029123372708820237,13081
2402,0.030801604880570956,4,0.027356732432627543,0.02907916865659925,13085
1040,0.02696325798884169,5,0.030636117892102466,0.02879968794047208,13090
1849,0.041774761288691085,3,0.01577928519289952,0.028777023240795303,13093
1349,0.041440599323999364,4,0.016002545434127532,0.028721572379063448,13097
2002,0.03867021600861595,1,0.01873380694807261,0.02870201147834428,13098
2654,0.03245886759735289,4,0.024824667181814048,0.028641767389583468,13102
2755,0.030553241258164943,3,0.02660406467327802,0.02857865296572148,13105
608,0.03249679949604762,2,0.024586433798659366,0.028541616647353493,13107
2158,0.030614203238210066,3,0.026452996366339306,0.028533599802274684,13110
1642,0.03971831049516931,1,0.017103606120806514,0.028410958307987913,13111
381,0.017581886615232814,3,0.03923899006157704,0.02841043833840493,13114
1269,0.03355844108927769,8,0.02316291580548819,0.02836067844738294,13122
1924,0.022379820229894386,7,0.033691975732814974,0.028035897981354682,13129
351,0.030182953675668717,9,0.02541156086983259,0.027797257272750654,13138
821,0.033917439416210005,4,0.021467742237361725,0.027692590826785865,13142
2677,0.041492529899593344,1,0.013886252249313507,0.027689391074453427,13143
1321,0.03046744291587922,9,0.024653545559794973,0.027560494237837095,13152
917,0.03867834427262197,4,0.01611377448843993,0.02739605938053095,13156
1628,0.008333728457278065,4,0.046423424411034135,0.0273785764341561,13160
2241,0.02222177065199965,8,0.03229118483006821,0.02725647774103393,13168
1758,0.03603530375999944,2,0.01813621815867787,0.027085760959338658,13170
2657,0.038096721825969335,1,0.01583810825046858,0.026967415038218957,13171
2407,0.034199670805307746,2,0.019636206126688822,0.026917938465998284,13173
2732,0.02336424331506731,3,0.03032863372753694,0.026846438521302127,13176
1972,0.030514857789247656,1,0.02295703510399649,0.026735946446622073,13177
2572,0.019022395625187677,3,0.03403181257904348,0.02652710410211558,13180
1956,0.03507797488817991,3,0.01778327981326353,0.02643062735072172,13183
1382,0.02657716544855599,4,0.026142838426429733,0.026360001937492862,13187
2168,0.03684135660726259,4,0.01545308460092566,0.026147220604094128,13191
2703,0.030338745402450667,4,0.021874156089657027,0.026106450746053847,13195
2475,0.030189727229007063,5,0.021986454654107056,0.02608809094155706,13200
866,0.03603530375999945,4,0.016002545434127532,0.02601892459706349,13204
1977,0.033982917098480676,1,0.018039962246292136,0.026011439672386408,13205
1171,0.0280492843740898,7,0.023953016419654388,0.026001150396872095,13212
591,0.012788468702796795,4,0.0391868514423681,0.02598766007258245,13216
481,0.00576203603981946,1,0.046058454076571574,0.025910245058195516,13217
370,0.02218790288530793,3,0.02936072705299155,0.02577431496914974,13220
1213,0.040207812616420445,3,0.011053387272294607,0.025630599944357527,13223
1841,0.027369671189142443,1,0.023882161373037107,0.025625916281089775,13224
1147,0.03922113168013474,1,0.01201193573313583,0.025616533706635285,13225
1416,0.02924594546386421,8,0.021938861452982995,0.025592403458423604,13233
45,0.04487930656876623,3,0.006132303751574184,0.025505805160170206,13236
859,0.03066839166491683,2,0.02029529174899667,0.025481841706956748,13238
574,0.017672200659744088,4,0.0331200551867231,0.02539612792323359,13242
2416,0.035236024466074656,5,0.015491854343414362,0.02536393940474451,13247
1311,0.029991036331082244,2,0.020637534993034813,0.02531428566205853,13249
645,0.02388354907100715,5,0.02658401135819766,0.025233780214602403,13254
2480,0.033757131987202496,3,0.016511899637168682,0.02513451581218559,13257
706,0.03375261628497692,3,0.016279281182236507,0.025015948733606713,13260
2450,0.02560854732117255,2,0.023793926786683534,0.024701237053928043,13262
1532,0.005766551742045024,2,0.04356114790523069,0.024663849823637857,13264
973,0.025208907674210138,3,0.023882161373037107,0.024545534523623624,13267
1523,0.028144114120826638,4,0.020606786576578263,0.02437545034870245,13271
1533,0.03384563975082355,3,0.014904425900327,0.024375032825575276,13274
2075,0.019008848518510986,4,0.029526501124322528,0.024267674821416757,13278
1101,0.0036080460782255087,2,0.0448632764977821,0.024235661288003803,13280
1776,0.03374584273163859,2,0.014695069290888041,0.024220456011263315,13282
646,0.024371244911368047,8,0.023832696529172224,0.024101970720270136,13290
1197,0.006766779785007417,2,0.04140207431491191,0.024084427049959667,13292
1569,0.03427643774314234,1,0.013886252249313507,0.024081344996227924,13293
1150,0.019799096407984655,1,0.028304585792092572,0.024051841100038614,13294
551,0.03705133676075133,7,0.011046702833934486,0.024049019797342905,13301
1757,0.020824160813187647,7,0.027260476520241814,0.024042318666714732,13308
257,0.023768398664255275,1,0.024308628540412776,0.024038513602334027,13309
179,0.010722534934601336,7,0.037333925128942826,0.024028230031772083,13316
1843,0.005084680705984884,3,0.042779068617096655,0.02393187466154077,13319
2766,0.027981548840706336,7,0.019423640986836996,0.023702594913771666,13326
2466,0.023267155717217686,7,0.024026545241615706,0.023646850479416698,13333
2588,0.02970203138864616,4,0.017569377785739686,0.023635704587192923,13337
2767,0.033131707228961894,1,0.014073416523396871,0.023602561876179384,13338
873,0.026951968733277782,1,0.02012149635163354,0.02353673254245566,13339
214,0.004682783207909703,8,0.04236597032644123,0.02352437676717547,13347
1725,0.03488154184136789,9,0.012102844094833462,0.023492192968100675,13356
2182,0.029180467781593538,1,0.017757878947495073,0.023469173364544307,13357
1176,0.025780144005743962,2,0.020815341053414007,0.023297742529578985,13359
1067,0.03890729037545804,1,0.007679082788105977,0.023293186581782005,13360
1435,0.019819417067999688,8,0.02669497303497565,0.02325719505148767,13368
1933,0.017800898173172656,4,0.028700304543011687,0.02325060135809217,13372
2709,0.03197117175699199,2,0.014395606452354659,0.023183389104673324,13374
1637,0.03232565438169875,8,0.01393705398085042,0.023131354181274585,13382
515,0.029991036331082244,5,0.01583810825046858,0.022914572290775412,13387
1851,0.030630008195999536,2,0.014935709071852364,0.02278285863392595,13389
1832,0.026066891097067273,3,0.019367491704611994,0.022717191400839633,13392
734,0.005134353430466087,7,0.0401387154648492,0.022636534447657643,13399
564,0.028001869500721373,4,0.01721777632799737,0.02260982291435937,13403
98,0.029747188410901796,8,0.015354154913195885,0.02255067166204884,13411
1345,0.02860245789672136,3,0.01644371836589546,0.022523088131308412,13414
1960,0.01581173134281178,9,0.028900837693815292,0.022356284518313535,13423
2202,0.030151343760089763,6,0.014378226912618346,0.022264785336354054,13429
1174,0.027981548840706347,7,0.01619505725889899,0.02208830304980267,13436
75,0.019620726170074886,1,0.023974406622406776,0.02179756639624083,13437
603,0.004687298910135266,1,0.03885530329970615,0.021771301104920707,13438
528,0.03325588904016492,4,0.01023120135399983,0.021743545197082374,13442
2020,0.03066839166491683,1,0.012818078999366314,0.02174323533214157,13443
1185,0.03160269045538599,3,0.011443491094991216,0.021523090775188602,13446
1716,0.026206877866059748,5,0.01658810223447405,0.0213974900502669,13451
1465,0.037868678863578364,1,0.004804774293254332,0.02133672657841635,13452
1372,0.02975396196424014,1,0.012812731448678219,0.02128334670645918,13453
1786,0.024050178483130458,1,0.018408141111167557,0.021229159797149007,13454
1824,0.03066839166491683,1,0.011749905749419124,0.021209148707167978,13455
499,0.029742672708676244,2,0.012541343251257343,0.021142007979966793,13457
1328,0.005947179831067577,9,0.036125378673433094,0.021036279252250337,13466
780,0.025369215103217664,5,0.016699063911252046,0.021034139507234855,13471
1298,0.0309709437140296,2,0.01108814635176723,0.021029545032898417,13473
852,0.019297853460947072,1,0.022506503958524396,0.020902178709735736,13474
2715,0.03075419000720254,7,0.010660342296719545,0.020707266151961043,13481
7,0.029322712401698803,1,0.012019957059167974,0.020671334730433387,13482
2642,0.028654388472315356,2,0.012465140653951972,0.020559764563133666,13484
1368,0.0027026477819999586,3,0.038406109041906084,0.020554378411953022,13487
136,0.0036080460782255087,3,0.03738606374815175,0.02049705491318863,13490
2648,0.02164827646935305,2,0.019232466049737565,0.020440371259545308,13492
936,0.031106414780796513,2,0.009609548586508664,0.02035798168365259,13494
1092,0.0313728412121048,7,0.009153669890348473,0.020263255551226635,13501
1366,0.018354974836249344,2,0.021961588543407403,0.020158281689828375,13503
2473,0.022210481396435743,5,0.018054668010684404,0.02013257470356007,13508
1777,0.020668369086405698,4,0.01942096721149295,0.020044668148949323,13512
2024,0.025549843192240216,3,0.013907642452065891,0.019728742822153054,13515
1941,0.02464534803645978,7,0.0147429298695465,0.01969413895300314,13522
2467,0.023036854903713926,2,0.016220458124667447,0.019628656514190684,13524
20,0.016565853614480947,5,0.02260275987091012,0.019584306742695533,13529
2521,0.01904271628520271,9,0.02011882257628949,0.0195807694307461,13538
2477,0.0270490563311274,3,0.01201193573313583,0.019530496032131615,13541
2459,0.030142312355638644,9,0.008790036443557938,0.01946617439959829,13550
425,0.02544823989216503,3,0.01331540121335925,0.01938182055276214,13553
1827,0.016229433798676442,7,0.02243163824889105,0.019330536023783748,13560
345,0.01699032962368395,9,0.021483784889426018,0.019237057256554984,13569
1819,0.026674253046405597,3,0.011725841771322689,0.019200047408864142,13572
5,0.01783702379097717,5,0.020481119135408003,0.019159071463192588,13577
10,0.018573083253744075,9,0.0195573297540394,0.019065206503891735,13586
1131,0.020912217006586138,4,0.017136226180003898,0.019024221593295018,13590
1643,0.019670398894556088,2,0.018132207495661797,0.018901303195108944,13592
159,0.021043172371127496,7,0.01673382299072467,0.018888497680926083,13599
1219,0.013869979385819334,7,0.023788579235995432,0.018829279310907384,13606
378,0.007213834305338234,5,0.030442269179658997,0.018828051742498617,13611
1483,0.025208907674210138,2,0.012367547853894219,0.01878822776405218,13613
2232,0.019769744343518494,5,0.01729264203763071,0.018531193190574603,13618
1023,0.0215669938292929,1,0.015430357510501246,0.018498675669897074,13619
1928,0.017846055195428295,6,0.019005195145493484,0.01842562517046089,13625
2293,0.019844253430240294,5,0.01697312588401697,0.01840868965712863,13630
1566,0.029638811557488272,3,0.00709486287543148,0.018366837216459875,13633
1831,0.029729125601999543,2,0.006934436354788598,0.01833178097839407,13635
1257,0.004511186523338277,3,0.03205321882444794,0.01828220267389311,13638
1500,0.02740805465805972,2,0.009045381988914525,0.018226718323487122,13640
922,0.003601272524887163,4,0.03283797188792603,0.018219622206406598,13644
1955,0.022535611956676346,4,0.013878230923281361,0.018206921439978853,13648
1556,0.023786461473157522,6,0.012482520193688286,0.018134490833422903,13654
1705,0.02359905983079663,6,0.012372895404582316,0.017985977617689473,13660
2221,0.011088306814872011,6,0.024803276979061664,0.017945791896966837,13666
863,0.01992102036807488,1,0.01595842814095074,0.01793972425451281,13667
2139,0.009374597820270532,2,0.026366098667657746,0.017870348243964138,13669
2719,0.02323328795052595,6,0.012322093673045403,0.01777769081178568,13675
2418,0.021099618648947042,3,0.014168335548110575,0.01763397709852881,13678
1638,0.024052887904465792,7,0.010840822132442788,0.01744685501845429,13685
1687,0.004059616300781893,2,0.030694940949671526,0.01737727862522671,13687
1088,0.005405295563999917,5,0.02934201062558322,0.017373653094791566,13692
376,0.007254475625368307,4,0.027481062986125775,0.01736776930574704,13696
463,0.009916482087338193,3,0.02480595075440571,0.017361216420871954,13699
910,0.024460204245211663,3,0.010215693457004354,0.01733794885110801,13702
202,0.011666316699744182,3,0.022646877164086913,0.017156596931915548,13705
611,0.024653476300465778,4,0.00957211573169199,0.017112796016078884,13709
1999,0.005992336853323215,4,0.02811742151800921,0.017054879185666214,13713
2513,0.02149474259368388,2,0.012408991371726965,0.016951866982705423,13715
1597,0.016658425510105004,2,0.016598797335850252,0.016628611422977627,13717
228,0.01974490798127789,3,0.013449089980561652,0.01659699898091977,13720
699,0.0309709437140296,3,0.0021323358368783136,0.016551639775453958,13723
1689,0.023452299508465807,1,0.009613559249524737,0.01653292937899527,13724
2023,0.007866353276932206,5,0.025001136354521218,0.016433744815726712,13729
1225,0.02299169788145829,2,0.009609548586508664,0.01630062323398348,13731
88,0.02164827646935305,9,0.010681732499471928,0.01616500448441249,13740
107,0.025522748978886827,7,0.006681764584776057,0.016102256781831442,13747
1680,0.02656587619299208,2,0.005526693636147303,0.016046284914569692,13749
876,0.025127625034149993,8,0.00671919743959273,0.01592341123687136,13757
2323,0.02584787953912742,4,0.005951823915850942,0.01589985172748918,13761
979,0.025382762209894348,3,0.006397007510634941,0.015889884860264644,13764
284,0.005181768303834507,8,0.02656796870613337,0.01587486850498394,13772
2146,0.003601272524887163,3,0.028146833046793742,0.01587405278584045,13775
1733,0.01180630346873666,3,0.019700376734945974,0.015753340101841318,13778
377,0.006306178157999902,1,0.02507065451346647,0.015688416335733184,13779
912,0.019482997252195187,3,0.011882257628949499,0.015682627440572344,13782
171,0.005414326968451045,4,0.02564685310010882,0.015530590034279933,13786
2111,0.0027049056331127403,4,0.028301912016748528,0.015503408824930634,13790
2775,0.02432157218688685,2,0.0066643850450397455,0.015492978615963297,13792
539,0.026958742286616127,5,0.003935797306438718,0.015447269796527423,13797
3,0.02065572512017412,6,0.010145640542990296,0.015400682831582208,13803
204,0.020359043483954575,7,0.010306067063633179,0.015332555273793878,13810
1667,0.019297853460947072,2,0.011362208324532155,0.015330030892739613,13812
2484,0.017861860153217772,4,0.012684390232163912,0.015273125192690841,13816
462,0.0037796427627969343,6,0.02674978542952864,0.015264714096162786,13822
201,0.01423349341497722,3,0.015997197883439434,0.015115345649208328,13825
1371,0.022799780536871827,5,0.007283364037186866,0.015041572287029346,13830
600,0.021311856653548542,2,0.008748592925725194,0.015030224789636868,13832
2368,0.008462425970706637,5,0.021296620615342654,0.014879523293024645,13837
2081,0.008119232601563785,4,0.02163351630869271,0.014876374455128247,13841
545,0.018270531204631298,4,0.011295363940930954,0.014782947572781126,13845
1613,0.01081059112799983,6,0.018678994553519623,0.014744792840759727,13851
1663,0.0016211370989774186,3,0.027836675106884166,0.014728906102930792,13854
1993,0.0254888812121951,4,0.0038261725173327483,0.014657526864763924,13858
2247,0.02336650116618008,4,0.005852894228121164,0.014609697697150623,13862
122,0.02016712613936811,4,0.008955810514888918,0.014561468327128515,13866
531,0.010688667167909609,3,0.01824985361079991,0.01446926038935476,13869
2308,0.010907678725849454,3,0.017990497402427245,0.01444908806413835,13872
1018,0.01910593611636061,5,0.009712488937254514,0.01440921252680756,13877
717,0.015692065233834342,3,0.013007917048793725,0.014349991141314033,13880
93,0.002343649455067633,9,0.026220377911407126,0.01428201368323738,13889
219,0.017468994059593717,4,0.01109483079012735,0.014281912424860533,13893
300,0.015233721457939615,1,0.013183049333828873,0.014208385395884244,13894
2309,0.020765456684255314,5,0.00755074157159167,0.014158099127923492,13899
396,0.001440509009954865,2,0.026440964377291088,0.013940736693622977,13901
2552,0.0032422741979548373,4,0.02399713371283118,0.013619703955393008,13905
2399,0.01804474609335311,2,0.00908174533359358,0.013563245713473344,13907
2751,0.013602649814065957,6,0.013450426868233677,0.013526538341149818,13913
1329,0.024560904404841728,2,0.0024237773493795503,0.01349234087711064,13915
700,0.018934339431789182,3,0.008007957155423887,0.013471148293606534,13918
2372,0.017231919692751615,2,0.009352866153480051,0.013292392923115834,13920
2542,0.01974490798127789,2,0.00680208447525822,0.013273496228268056,13922
331,0.004057358449669111,1,0.022422280035186884,0.013239819242427998,13923
128,0.0035154741826014494,4,0.022896875158755405,0.013206174670678427,13927
596,0.005041781534842028,7,0.021323358368783137,0.013182569951812582,13934
2055,0.024560904404841728,2,0.0017312695352711073,0.013146086970056417,13936
1564,0.009550710207067522,3,0.01649184632208833,0.013021278264577926,13939
835,0.004863411296932256,4,0.021117477667291436,0.012990444482111847,13943
2479,0.01787314940878168,3,0.007757959160755393,0.012815554284768537,13946
2493,0.008202773092736716,1,0.017346117544511673,0.012774445318624195,13947
1681,0.017757999002029803,6,0.0076322917195851365,0.01269514536080747,13953
1647,0.010363536607669014,2,0.014875549126611284,0.012619542867140149,13955
946,0.0021607635149322978,1,0.023029227038285787,0.012594995276609042,13956
2696,0.002201404834962372,6,0.02293029735055601,0.01256585109275919,13962
1068,0.0027026477819999586,2,0.022403563607778544,0.012553105694889252,13964
1814,0.020286792248345554,7,0.004804774293254332,0.012545783270799943,13971
1008,0.016229433798676442,3,0.008808752870966274,0.012519093334821358,13974
373,0.022016306200736503,1,0.002926447114060582,0.012471376657398543,13975
2119,0.01754350314631552,4,0.00727133204813865,0.012407417597227086,13979
2021,0.0036103039293382904,3,0.021098761239883097,0.012354532584610693,13982
1284,0.02122605831126283,2,0.0030227030264463116,0.012124380668854571,13984
868,0.017928692546156113,10,0.006243532805886583,0.012086112676021348,13994
2721,0.0020727073215338026,4,0.02209073189252492,0.012081719607029362,13998
1049,0.01235947699136823,1,0.01177263283984353,0.012066054915605879,13999
836,0.006545510375954786,5,0.01737953973631227,0.011962525056133528,14004
1475,0.017577370913007248,3,0.006244602316024203,0.011910986614515725,14007
899,0.0021630213660450794,3,0.021555976823715316,0.011859499094880198,14010
385,0.013779665341308058,4,0.009864894131865252,0.011822279736586654,14014
1542,0.015400802440285473,2,0.0081590254623626,0.011779913951324036,14016
435,0.00857306067523295,4,0.014963783712964867,0.011768422194098908,14020
1081,0.016175245371969675,2,0.0071830974617850644,0.01167917141687737,14022
1034,0.01373450831905242,2,0.009610885474180687,0.011672696896616553,14024
2428,0.016405546185473432,1,0.0069384470178046696,0.011671996601639052,14025
1241,0.0008105685494887093,5,0.02207736301580468,0.011443965782646694,14030
1196,0.013472597589969718,1,0.009204471621885386,0.011338534605927552,14031
2125,0.01988263689915759,1,0.0027700312564337714,0.011326334077795682,14032
2448,0.0027071634842255224,3,0.01958139373213584,0.011144278608180682,14035
537,0.015145665264541119,3,0.006883634623251684,0.011014649943896402,14038
1611,0.0017114511434886954,3,0.020316681951749044,0.01101406654761887,14041
57,0.0027049056331127403,3,0.019219097173017327,0.010962001403065033,14044
837,0.017116769285999738,3,0.004800763630238259,0.010958766458119,14047
157,0.01482956610875165,7,0.007030692267174327,0.01093012918796299,14054
1670,0.0020727073215338026,3,0.019636206126688822,0.010854456724111313,14057
2725,0.013434214121052425,4,0.008272660914484645,0.010853437517768535,14061
1859,0.017581886615232814,1,0.0040039785777119434,0.010792932596472378,14062
2520,0.0029735899155337885,5,0.018569369764413653,0.010771479839973721,14067
330,0.011822108426526133,2,0.00954537797825151,0.010683743202388822,14069
2351,0.008916254044375802,5,0.012227174648331698,0.01057171434635375,14074
678,0.015233721457939615,4,0.005550757614243736,0.010392239536091676,14078
2052,0.012422696822526126,2,0.008293783739702623,0.010358240281114374,14080
2277,0.0011718247275338165,2,0.019427651649853075,0.010299738188693446,14082
1536,0.013779665341308058,1,0.00671919743959273,0.010249431390450394,14083
2460,0.0005847834382105173,2,0.01987684590765315,0.010230814672931835,14085
686,0.011110885325999829,3,0.009348855490463978,0.010229870408231903,14088
1692,0.012436243929202815,1,0.007977208738967335,0.010206726334085075,14089
241,0.010056468856330672,5,0.010328794154057587,0.01019263150519413,14094
744,0.01585237266284186,1,0.004136330457242323,0.009994351560042091,14095
262,0.0135245281655637,5,0.006406365724339109,0.009965446944951405,14100
942,0.003197117175699199,5,0.016558690705689525,0.009877903940694361,14105
2230,0.011846944788766736,4,0.007868920837533388,0.009857932813150061,14109
2361,0.0036080460782255087,1,0.016022598749207893,0.009815322413716701,14110
1364,0.0009008825939999861,3,0.018673647002831525,0.009787264798415756,14113
2267,0.001754350314631552,2,0.01765894925976529,0.00970664978719842,14115
2422,0.0027071634842255224,5,0.016666978607123472,0.009687071045674497,14120
420,0.01487698098212007,7,0.004431515255225225,0.009654248118672649,14127
789,0.0135245281655637,1,0.005605570008796721,0.00956504908718021,14128
1112,0.015276620629082466,1,0.0037245690542589225,0.009500594841670694,14129
2329,0.014976326431082475,6,0.003838204506380965,0.00940726546873172,14135
2580,0.0023391337528420693,1,0.016273933631548408,0.00930653369219524,14136
517,0.0025242775440901867,5,0.01606805293005671,0.00929616523707345,14141
1026,0.01152407207963892,3,0.0070459327866354005,0.00928500243313716,14144
55,0.01403480251705241,2,0.0045013007917048785,0.009268051654378644,14146
2162,0.006755490529443505,9,0.011523971732847062,0.009139731131145284,14155
95,0.011469883652932155,2,0.006784704935521907,0.009127294294227031,14157
1811,0.012969096791819349,10,0.005279369416822859,0.009124233104321105,14167
275,0.005412069117338263,2,0.012818078999366314,0.009115074058352289,14169
1675,0.0020727073215338026,4,0.015954417477934663,0.009013562399734233,14173
209,0.00676226408278185,7,0.011211140017593442,0.008986702050187647,14180
1084,0.004057358449669111,2,0.013613527164220606,0.008835442806944859,14182
805,0.008864323468781816,4,0.008795383994246035,0.008829853731513924,14186
2669,0.011232809286090053,1,0.006384975521586725,0.008808892403838389,14187
1563,0.011711473721999821,2,0.0058675999925134285,0.008789536857256624,14189
58,0.0043215270298645955,5,0.013229840402349712,0.008775683716107154,14194
1278,0.01054642254780435,1,0.0069384470178046696,0.008742434782804509,14195
2757,0.012975870345157696,7,0.004350232484766165,0.008663051414961931,14202
2258,0.01351323890999979,2,0.0036269762542011684,0.00857010758210048,14204
1772,0.008918511895488585,4,0.008215174744587607,0.008566843320038096,14208
1363,0.0031564758556691247,2,0.013884915361641482,0.008520695608655303,14210
102,0.011718247275338165,1,0.004856912912463269,0.008287580093900716,14211
1130,0.012172075349007333,3,0.0040039785777119434,0.008088026963359638,14214
1616,0.0018017651879999722,5,0.014346141608489769,0.008073953398244871,14219
285,0.0,8,0.016030620075240042,0.008015310037620021,14227
1020,0.011325381181714111,2,0.0046042411424507285,0.007964811162082419,14229
92,0.007216092156451017,4,0.008545385999577543,0.00788073907801428,14233
997,0.003145186600105215,3,0.012503910396440669,0.007824548498272941,14236
832,0.0007202545049774325,3,0.014926350858148196,0.007823302681562814,14239
2602,0.01328293809649604,1,0.002338216538370013,0.007810577317433026,14240
1396,0.010810591127999834,4,0.004800763630238259,0.0078056773791190465,14244
2653,0.01297135464293213,2,0.0025601398919260004,0.007765747267429065,14246
2502,0.002343649455067633,1,0.013183049333828873,0.007763349394448253,14247
187,0.00288101801990973,2,0.012367547853894219,0.007624282936901974,14249
2468,0.006303920306887121,4,0.008937094087480581,0.007620507197183851,14253
516,0.0008105685494887093,2,0.014398280227698707,0.007604424388593708,14255
644,0.011718247275338165,2,0.0034692235089023348,0.00759373539212025,14257
1229,0.011718247275338165,3,0.0034692235089023348,0.00759373539212025,14260
1621,0.0018017651879999722,3,0.01333545452843961,0.007568609858219791,14263
170,0.002431705648466128,1,0.012478509530672213,0.00745510758956917,14264
648,0.009692954827172784,6,0.0051015633564436644,0.007397259091808224,14270
2027,0.005412069117338263,2,0.009347518602791956,0.007379793860065109,14272
70,0.0018040230391127544,1,0.012818078999366314,0.007311051019239534,14273
1424,0.008916254044375802,3,0.0056028962334526726,0.007259575138914237,14276
1620,0.009672634167157745,6,0.004613599356154897,0.007143116761656321,14282
318,0.002343649455067633,4,0.011795359930267937,0.007069504692667785,14286
254,0.0,6,0.01409988689930294,0.00704994344965147,14292
2291,0.003827057636165355,3,0.010243233343048051,0.007035145489606703,14295
2686,0.007557027674481085,7,0.006403691948995061,0.006980359811738073,14302
808,0.010810591127999834,4,0.0026670909056879222,0.0067388410168438785,14306
1549,0.0008105685494887093,6,0.01264027293898712,0.0067254207442379145,14312
1102,0.009356535011368277,4,0.0038087929775964357,0.006582663994482357,14316
1694,0.004642141887879627,4,0.008483889166664435,0.006563015527272032,14320
1334,0.0027049056331127403,4,0.010410344302051053,0.006557624967581896,14324
2747,0.0011718247275338165,3,0.011795359930267937,0.006483592328900877,14327
2633,0.009374597820270532,4,0.0034692235089023348,0.006421910664586434,14331
523,0.010334184543202849,4,0.002394365820595022,0.006364275181898935,14335
1025,0.009467169715894591,1,0.0032031828621695547,0.006335176289032073,14336
1163,0.0007202545049774325,2,0.011941080686518557,0.006330667595747995,14338
188,0.0020727073215338026,10,0.010348847469137947,0.006210777395335875,14348
71,0.00676226408278185,3,0.005605570008796721,0.006183917045789286,14351
1307,0.008202773092736716,2,0.004163068210682802,0.006182920651709759,14353
15,0.0036103039293382904,3,0.00855073355026564,0.006080518739801965,14356
1480,0.009726822593864513,1,0.002399713371283118,0.0060632679825738155,14357
1165,0.009810363085037443,1,0.0020066683957080554,0.005908515740372749,14358
343,0.010083563069684054,3,0.001705868669502651,0.005894715869593352,14361
1581,0.006306178157999903,6,0.005310117833279411,0.005808147995639657,14367
1684,0.0021607635149322978,1,0.00938227768226458,0.005771520598598439,14368
2470,0.0018040230391127544,2,0.009613559249524737,0.005708791144318746,14370
1622,0.004872442701383384,9,0.006505295412068887,0.005688869056726135,14379
2001,0.002343649455067633,4,0.009019981123146071,0.005681815289106852,14383
767,0.005181768303834507,5,0.006136314414590257,0.005659041359212382,14388
1657,0.004057358449669111,6,0.007207161439881498,0.005632259944775304,14394
944,0.005041781534842028,6,0.006189789921471217,0.0056157857281566225,14400
337,0.0016211370989774186,5,0.00960821169883664,0.005614674398907029,14405
1673,0.0,9,0.011220498231297608,0.005610249115648804,14414
2140,0.0,5,0.011220498231297608,0.005610249115648804,14419
888,0.0,7,0.011045365946262462,0.005522682973131231,14426
402,0.0054098112662254805,7,0.005605570008796721,0.0055076906375111,14433
2589,0.0018017651879999722,3,0.009068109079338934,0.005434937133669453,14436
558,0.0010363536607669013,2,0.009818103063344411,0.005427228362055656,14438
2018,0.008643054059729191,2,0.0021323358368783136,0.0053876949483037525,14440
2012,0.0,3,0.010689753825504073,0.005344876912752036,14443
506,0.0018040230391127544,1,0.008545385999577543,0.005174704519345149,14444
940,0.008107943345999872,5,0.002137416010032005,0.005122679678015938,14449
2283,0.007897963192511154,2,0.002338216538370013,0.005118089865440583,14451
989,0.0011718247275338165,5,0.008971853166953207,0.0050718389472435114,14456
688,0.0009008825939999861,2,0.009068109079338934,0.0049844958366694605,14458
988,0.0027049056331127403,4,0.007207161439881498,0.004956033536497119,14462
2587,0.00855048216410513,6,0.001332877009007949,0.0049416795865565395,14468
2435,0.0068209682117141785,1,0.002975911957925471,0.004898440084819825,14469
2326,0.0010363536607669013,4,0.00859084018042636,0.004813596920596631,14473
1037,0.0,7,0.009446448290521733,0.0047232241452608665,14480
140,0.0009008825939999861,1,0.008534690898201351,0.004717786746100669,14481
317,0.0,3,0.009348855490463982,0.004674427745231991,14484
2469,0.005859123637669082,1,0.0034692235089023348,0.004664173573285709,14485
2332,0.005642369930842018,1,0.0036590615583297456,0.004650715744585882,14486
1976,0.00818696813494724,3,0.0010387617211626643,0.004612864928054952,14489
448,0.00676226408278185,3,0.002402387146627166,0.004582325614704508,14492
2688,0.005412069117338263,3,0.0037341946454974954,0.004573131881417879,14495
1618,0.0027071634842255224,1,0.006411713275027205,0.004559438379626364,14496
1047,0.0036080460782255087,1,0.005340866249735964,0.004474456163980737,14497
2225,0.0036035303759999445,7,0.005069478052315088,0.004336504214157516,14504
2313,0.0027026477819999586,3,0.0058675999925134285,0.0042851238872566935,14507
804,0.00537368564842097,1,0.0031817926594171703,0.00427773915391907,14508
195,0.0035154741826014494,2,0.004856912912463269,0.004186193547532359,14510
40,0.005172736899383379,1,0.0030628096566070323,0.004117773277995206,14511
2328,0.0,7,0.008013304706111985,0.004006652353055993,14518
1741,0.007207060751999889,3,0.0007459833209894038,0.003976522036494646,14521
398,0.006306178157999903,2,0.0016002545434127533,0.003953216350706328,14523
2551,0.00576203603981946,3,0.0021323358368783136,0.003947185938348887,14526
232,0.001440509009954865,5,0.006397007510634941,0.003918758260294903,14531
908,0.007207060751999889,1,0.0005334181811375844,0.003870239466568737,14532
500,0.00538497490398488,2,0.002338216538370013,0.0038615957211774465,14534
960,0.0021607635149322978,2,0.005544073175883615,0.0038524183454079564,14536
870,0.0018017651879999722,2,0.0058675999925134285,0.0038346825902567,14538
803,0.007216092156451017,6,0.0,0.0036080460782255087,14544
2007,0.006306178157999903,1,0.0005334181811375844,0.0034197981695687435,14545
2047,0.0005847834382105173,4,0.006232570326975986,0.0034086768825932518,14549
817,0.0,1,0.00671919743959273,0.003359598719796365,14550
1907,0.0018017651879999722,3,0.004800763630238259,0.0033012644091191153,14553
218,0.0003589983269323253,4,0.006164389055702761,0.003261693691317543,14557
729,0.005412069117338263,2,0.0010681732499471929,0.0032401211836427276,14559
1919,0.004061874151894675,4,0.002405060921971214,0.0032334675369329446,14563
2455,0.0023820329239849255,8,0.004074833624329215,0.0032284332741570705,14571
1748,0.005391748457323225,3,0.0010641625869311207,0.003227955522127173,14574
2670,0.0,2,0.006411713275027205,0.0032058566375136027,14576
1630,0.0,2,0.006397007510634941,0.0031985037553174706,14578
1249,0.0022555932616691384,1,0.004006652353055993,0.0031311228073625658,14579
429,0.0,1,0.006244602316024203,0.0031223011580121013,14580
1253,0.005391748457323225,2,0.0007981219401983407,0.003094935198760783,14582
1354,0.0011718247275338165,6,0.004856912912463269,0.0030143688199985425,14588
1415,0.0,1,0.005609313294278388,0.002804656647139194,14589
2436,0.0,1,0.005550757614243736,0.002775378807121868,14590
312,0.00288101801990973,2,0.0025588030042539766,0.0027199105120818533,14592
2576,0.0,3,0.005414395071697285,0.0027071975358486425,14595
2408,0.0007202545049774325,1,0.00469113884113229,0.002705696673054861,14596
930,0.0,3,0.005342203137407989,0.0026711015687039944,14599
732,0.0,4,0.005342203137407989,0.0026711015687039944,14603
592,0.0,1,0.005342203137407989,0.0026711015687039944,14604
2363,0.0,3,0.005342203137407989,0.0026711015687039944,14607
599,0.0036035303759999445,3,0.0016002545434127533,0.002601892459706349,14610
2638,0.0017949916346616265,4,0.00340104223762911,0.002598016936145368,14614
1343,0.00450441296999993,1,0.0005334181811375844,0.0025189155755687576,14615
1394,0.0,1,0.004856912912463269,0.0024284564562316343,14616
1290,0.0,1,0.004808784956270405,0.0024043924781352024,14617
1324,0.0,2,0.004800763630238259,0.0024003818151191294,14619
1154,0.0032309849423909276,2,0.0012753908391109161,0.002253187890750922,14621
2244,0.0018017651879999722,4,0.0026670909056879222,0.0022344280468439472,14625
295,0.004093484067473622,3,0.0003462539070542214,0.0022198689872639215,14628
72,0.001440509009954865,1,0.0029852701716296393,0.002212889590792252,14629
1184,0.0027071634842255224,3,0.0016029283187568013,0.0021550459014911616,14632
972,0.0,4,0.0042726929997887715,0.0021363464998943858,14636
721,0.0,6,0.0041590575476667295,0.0020795287738333648,14642
2559,0.0036035303759999445,1,0.0005334181811375844,0.0020684742785687642,14643
1970,0.0,4,0.004006652353055993,0.0020033261765279964,14647
1466,0.0,3,0.0040039785777119434,0.0020019892888559717,14650
1204,0.001440509009954865,6,0.0025588030042539766,0.001999656007104421,14656
2413,0.0013524528165563701,1,0.002402387146627166,0.001877419981591768,14657
2373,0.0022555932616691384,4,0.0013355507843519972,0.001795572023010568,14661
1816,0.0009008825939999861,1,0.0026670909056879222,0.0017839867498439543,14662
1930,0.0003589983269323253,3,0.0032005090868255067,0.0017797537068789159,14665
1833,0.0,1,0.0034692235089023348,0.0017346117544511674,14666
1497,0.0013411635609924604,3,0.0021176300724860494,0.001729396816739255,14669
1751,0.0017091932923759135,6,0.0015441052611877444,0.001626649276781829,14675
2213,0.0,3,0.0032077282802544364,0.0016038641401272182,14678
1615,0.0,9,0.0032045197498415784,0.0016022598749207892,14687
1123,0.002343649455067633,4,0.000693844701780467,0.00151874707842405,14691
1312,0.0,5,0.0029852701716296393,0.0014926350858148196,14696
1798,0.0010363536607669013,2,0.0018408943243770769,0.001438623992571989,14698
964,0.0,1,0.002775378807121868,0.001387689403560934,14699
391,0.0,3,0.002775378807121868,0.001387689403560934,14702
360,0.0,3,0.0026711015687039944,0.0013355507843519972,14705
1662,0.0,1,0.0026670909056879222,0.0013335454528439611,14706
2219,0.0,5,0.0026670909056879222,0.0013335454528439611,14711
534,0.0016233949500902007,1,0.0009612222361852713,0.001292308593137736,14712
1332,0.0011718247275338165,4,0.001387689403560934,0.0012797570655473751,14716
2169,0.0007202545049774325,1,0.001705868669502651,0.0012130615872400418,14717
1590,0.0,2,0.002402387146627166,0.001201193573313583,14719
906,0.0018053777497804232,4,0.0005344876912752036,0.0011699327205278135,14723
1974,0.0018017651879999722,2,0.0005334181811375844,0.0011675916845687783,14725
383,0.0018017651879999722,1,0.0005334181811375844,0.0011675916845687783,14726
113,0.0,7,0.0021336727245503378,0.0010668363622751689,14733
2270,0.0003589983269323253,3,0.001700521118814555,0.0010297597228734402,14736
125,0.0007202545049774325,1,0.0012794015021269883,0.0009998280035522105,14737
1711,0.0007179966538646506,7,0.0012753908391109161,0.0009966937464877834,14744
1226,0.0005847834382105173,2,0.0013850156282168857,0.0009848995332137015,14746
820,0.0009008825939999861,1,0.0010668363622751689,0.0009838594781375774,14747
578,0.0,1,0.0019197706970264941,0.0009598853485132471,14748
2381,0.0017949916346616265,2,0.0,0.0008974958173308133,14750
1301,0.0,1,0.0016015914310847773,0.0008007957155423887,14751
298,0.00107022142745863,2,0.0005280706304494884,0.0007991460289540591,14753
468,0.000535110713729315,5,0.0009505271348090793,0.0007428189242691971,14758
2237,0.001440509009954865,1,0.0,0.0007202545049774325,14759
1727,0.0,3,0.0013850156282168857,0.0006925078141084429,14762
2201,0.00040415534918796366,6,0.000957211573169199,0.0006806834611785813,14768
2043,0.0013524528165563701,1,0.0,0.0006762264082781851,14769
141,0.0013524528165563701,2,0.0,0.0006762264082781851,14771
1272,0.0,1,0.0010668363622751689,0.0005334181811375844,14772
1042,0.0,4,0.0010668363622751689,0.0005334181811375844,14776
1486,0.0002235272601654101,1,0.0007941112771822687,0.0005088192686738395,14777
1889,0.0005847834382105173,5,0.0003462539070542214,0.00046551867263236934,14782
1877,0.0008105685494887093,2,0.0,0.00040528427474435466,14784
672,0.0,5,0.0008018652256800078,0.0004009326128400039,14789
479,0.0,2,0.0008007957155423887,0.00040039785777119433,14791
2711,0.0,3,0.0008007957155423887,0.00040039785777119433,14794
740,0.0007202545049774325,3,0.0,0.00036012725248871626,14797
783,0.00045111865233382766,1,0.0002671101568703994,0.00035911440460211354,14798
2524,0.00044931237144360206,3,0.00026604064673278017,0.0003576765090881911,14801
2121,0.0,1,0.000693844701780467,0.0003469223508902335,14802
607,0.0,2,0.000693844701780467,0.0003469223508902335,14804
2437,0.0,3,0.0006376954195554581,0.00031884770977772903,14807
636,0.0,1,0.0006376954195554581,0.00031884770977772903,14808
1770,0.0003589983269323253,4,0.00021256513985181937,0.00028578173339207237,14812
1387,0.000535110713729315,4,0.0,0.0002675553568646575,14816
2761,0.0,1,0.0005334181811375844,0.0002667090905687922,14817
2080,0.0004944693936992405,4,0.0,0.00024723469684962026,14821
2172,0.0,3,0.00047994267425662354,0.00023997133712831177,14824
2242,0.0003589983269323253,5,0.0,0.00017949916346616265,14829
561,0.0003589983269323253,2,0.0,0.00017949916346616265,14831
2280,0.0,1,0.0002927784001732606,0.0001463892000866303,14832
1029,0.0,2,0.0,0.0,14834
124,0.0,2,0.0,0.0,14836
1752,0.0,2,0.0,0.0,14838
2337,0.0,2,0.0,0.0,14840
2494,0.0,3,0.0,0.0,14843
567,0.0,2,0.0,0.0,14845
1802,0.0,4,0.0,0.0,14849
2496,0.0,2,0.0,0.0,14851
2406,0.0,1,0.0,0.0,14852
2105,0.0,2,0.0,0.0,14854
1162,0.0,1,0.0,0.0,14855
2568,0.0,1,0.0,0.0,14856
538,0.0,2,0.0,0.0,14858
483,0.0,6,0.0,0.0,14864
126,0.0,3,0.0,0.0,14867
1587,0.0,2,0.0,0.0,14869
363,0.0,3,0.0,0.0,14872
